Welcome
An Interactive Fiction
Release 1 / Serial number 250112 / Inform 7 v10.1.2 / D

Soba of Awakening
You find yourself in a nearly empty room. The walls are gray and bare. In the middle of the room stands an old wooden table with a single chair. Hanging on the wall is an antique clock, its ticking echoing in your mind-strangely familiar yet distant. A vague memory lingers: the sensation of falling. This is something you will never forget, and the surname "Krševean" echoes faintly in the distance, though you can't quite remember its significance. West is door and north is door

You can see a wooden table and an antique clock here.

I beg your pardon?

* * *

>Eat apple
(first taking the apple)
You eat the apple. Not bad.

>take apple
You can't see any such thing.

* * *

>ask about misljenje
You can't see any such thing.

>ask player about misljenje
You can't see any such thing.

>misljenje
That's not a verb I recognise.

* * *

>go w
The Town Square
You step outside into the bustling town square. The air is filled with the sound of distant chatter and the smell of fresh bread from the bakery. In front of you, there are four people standing: three of them are strangers, and only one of them feels oddly familiar - Krševan.

You can see Krsevan here.

>ask krsevan about town
Krsevan seems irritated. He doesn't want to talk right now. He looks like he's in no mood for conversation. He tells you to talk with Laura, Nona, and Sarmelo.

>ask laura about t
Laura seems lost in thought. She doesn't seem to want to talk right now. Perhaps she's too focused on her cravings.

>ask laura about t
Laura seems lost in thought. She doesn't seem to want to talk right now. Perhaps she's too focused on her cravings.

>ask laura about t
Laura seems lost in thought. She doesn't seem to want to talk right now. Perhaps she's too focused on her cravings.

The sound of the clock grows louder and more insistent. You feel its ticking resonating in your mind, as if urging you to act. It is so loud that you need to go back to the room (east) and turn it off
The sound of the clock becomes deafening. You feel an overwhelming urge to return to the Soba of Awakening. (east)

>e
The dizziness overwhelms you, and you need a moment to steady yourself.

Soba of Awakening
You stagger back into the room, your head spinning. You feel dizzy, and the air seems to buzz around you. The room has changed. It looks much tidier and cleaner now, as though someone has spent a long time organizing it. The once-bare walls are now spotless, and the table is neatly arranged with a small, mysterious object on it. The clock ticks more softly, almost as if it's calming you. You wonder if everything that just happened was real.

You can see Nona computer, a wooden table and an antique clock here.

>look at computer
The computer's screen flickers erratically, displaying strange symbols, but when you look closer, it's a Ryanair ticket??? You take a better look and try to find something on the computer that will help you understand, and you see the time on the computer is 5.6.2019!!!! Are we a few days in the past???? And you can see that ticket is sent on email to NONAAA?!?!?!?

>[enter]
*Thinks*

>[enter]
~~Hmmm, this room looks different. It has purple walls, and everything is purple. There are a lot of chocolates on the table and tiger prints?? Is this Nona's room? How is that possible? What is happening??~~

The sound of the clock grows louder and more insistent. You feel its ticking resonating in your mind, as if urging you to act. It is sooooo loud you need to go back to room (east) and turn it of

* * *

>[enter]
You find yourself again in a nearly empty room. The walls are gray and bare. Its ticking echoes in your mind, strangely familiar yet distant.

>[enter]
What is happening room was purple with tiger print all around me.... and the clock was so lound but now it's quiet
I should ask Nona about this mybe she knows something about flight

>w
The Town Square
You step outside into the bustling town square. The air is filled with the sound of distant chatter and the smell of fresh bread from the bakery. In front of you, there are four people standing: three of them are strangers, and only one of them feels oddly familiar - Krševan.

You can see Sarmelo, Nona, Laura and Krsevan here.

>your ticket is on email
Nona: WHAT DO YOU KNO... Wait they are on my email... Well *rolls her eyes* that is a relief.

>[enter]
Nona: Wait what are you doing here in Varazdin?

>[enter]
Player: Well... mmmm.... I am here to visit someone?!

>[enter]
Nona: Oooo who??

>[enter]
Player: Aren't you curious?

>[enter]
Player **thinks*~~Okay, so I know that I am in Varaždin, and now what... Nona is way too curious, and I don't know whether I should trust her. The best thing is to ignore her from now on, and she's probably ready for the pension fund.~~

>[enter]
Player **thinks**~~I should go to room and sleep to clear my mind. What happened today? Why was the clock so loud, and where was I in that purple room? Did I go crazy?~~That's not a verb I recognise.

>e
Soba of Awakening

 You find yourself again in a nearly empty room. The walls are gray and bare. Its ticking echoes in your mind, strangely familiar yet distant.

You can see a wooden table and an antique clock here.

>sleep
Player fell asleep
 The sound of the clock grows louder and more insistent. You feel its ticking resonating in your mind, as if urging you to act. It wakes you up.

>[enter]
Player: WHATTTT??? 
 What is happening... Why is everything so noisy? 
(new place unlocked: living room) 
 Player: I should go and check what is happening in living room (north).

You aren't feeling especially drowsy.

I beg your pardon?

>n
Player: Why is Laura, Nona, Sarmelo and Krsevan here and what are they doing???

>a
It looks like they are playing some game... is that... catan and Krsevan is winning... no wayyy...

>s
Player: I want to join and show you how to play catan.

>[enter]
After a few minutes of playing, I see Sarmelo with a banana, and Laura's favorite drink is Pepsi and milk?? Is that PILK??? Disgusting, maybe she's craving PILK. 
 Wait, what time is it? Where am I? Why is everyone so friendly right now? This is weird. I should ask what time it is.

>ask laura about time
Laura: It's 21:20 1.7.2019.

>[enter]
Player: What am I in the FUTURE??? This is some weird dream... oh, at least I'll show them how to play Catan.

>[enter]
After playing and almost winning, you stand up and feel a strange sensation of falling, after which you wake up.

Soba of Awakening

 You find yourself again in a nearly empty room. The walls are gray and bare. Its ticking echoes in your mind, strangely familiar yet distant.

You can see a wooden table and an antique clock here.

>[enter]
You are awake now you should probably look at you wierd power of thinking and see if something will help you with Laura, Krsevan or Sarmelo and ask what is happening

>w
The Town Square
You step outside into the bustling town square. The air is filled with the sound of distant chatter and the smell of fresh bread from the bakery. In front of you, there are four people standing: three of them are strangers, and only one of them feels oddly familiar - Krševan.

You can see Krsevan, Sarmelo, Nona and Laura here.

>ask laura about what is happening
Laura: I don't know.. what do you mean?? you ok??

>[enter]
Choose answer: 
 1) No no I am ok just little bit tired
 2) I don't know what is happening I am lost... I have some wierd dreams and something is wrong, sometimes I feel like I am falling... and that falling is always with me!!!

>1
Laura: Oh, okay, good. I don't have time for you right now. I just have this weird craving and I don't know for what. Any idea?? (you should just say drink you know she loves).
That's not a verb I recognise.

I beg your pardon?

>e
Soba of Awakening

 You find yourself again in a nearly empty room. The walls are gray and bare. Its ticking echoes in your mind, strangely familiar yet distant.

You can see a wooden table and an antique clock here.

>pilk
Laura: OMG, yes, that's exactly what I need! Thank you so much. Now I can buy what I need. Do you want something, like fruit or something...?

>[enter]
Player: *Thinks**~~Hmmmm fruit maybe Sarmelo would like to have fruit.... BANANA ~~ 
Yes buy me banana.

>[enter]
Laura; Ok see you tomorrow

>[enter]
Player: I should think about everything...

>[enter]
After trying to piece everything together player head starts to heart and he can hear something???

>[enter]
The sound of the clock grows louder and more insistent. You feel its ticking resonating in your mind, as if urging you to act. You need to run and see that clockThat's not a verb I recognise.

>w
The Town Square
You step outside into the bustling town square. The air is filled with the sound of distant chatter and the smell of fresh bread from the bakery. In front of you, there are four people standing: three of them are strangers, and only one of them feels oddly familiar - Krševan.

You can see Krsevan, Sarmelo, Nona and Laura here.

>e
Soba of Awakening

 You find yourself again in a nearly empty room. The walls are gray and bare. Its ticking echoes in your mind, strangely familiar yet distant.

You can see a wooden table and an antique clock here.

Player: What is happening with this clock? I NEED TO SMASH IT, I CANNOT WITH THIS SOUND!

Weird noises: smash.... smash.... smash........

>smash
Player starts to feel wierd and everything is green....

>[enter]
Player; Why is everything soo green what is this turquoise green colour...

>[enter]
Player: Are walls green ???? What in the h....

 You hear footesteps someone is coming in room...

>[enter]
Krsevan enters the room.

 Krsevan: What are you doing here? This is my room!

>[enter]
Player: But... everything's green!

>[enter]
Krsevan: It's my style, deal with it.

>[enter]
Player: It's... too much green.

 Krsevan: Get used to it.

>[enter]
Player **thinks*~~I shouled probably ask Krsevan what is happening??~~ (ask krsevan about what is happening).

What do you want to smash?

>ask krsevan about what is happening
Krsevan: WHY ARE YOU CALLING ME BY MY LAST NAME?!?!?! YOU OK!!

Krsevan runs out of room and slams the door

>[enter]
*Thinks*~~Huh, what's up with him??? Anyway, let's explore the room. Maybe I will understand what is happening. (look)~~

I beg your pardon?

>look at banana
This banana has massage on it: "Sarmelo is crazy for bananas soo I will gift him one"

Player: ~~I feel dizzy... why is this green so overwhelming... damn, the green~~

>[enter]
You find yourself again in a nearly empty room. The walls are gray and bare. Its ticking echoes in your mind, strangely familiar yet distant.

>[enter]
You should probably go and see Laura ask her about banana??

>w
The Town Square
You step outside into the bustling town square. The air is filled with the sound of distant chatter and the smell of fresh bread from the bakery. In front of you, there are four people standing: three of them are strangers, and only one of them feels oddly familiar - Krševan.

You can see Sarmelo, Nona and Laura here.

I beg your pardon?

>ask laura about banana
Laura: OOO Yeaa! Take it (Type take hidden banana)

Player: ~~I feel dizzy... why is this green so overwhelming... damn, the green~~

>[enter]
You find yourself again in a nearly empty room. The walls are gray and bare. Its ticking echoes in your mind, strangely familiar yet distant.

* * *

>go west
The Town Square
You step outside into the bustling town square. The air is filled with the sound of distant chatter and the smell of fresh bread from the bakery. In front of you, there are four people standing: three of them are strangers, and only one of them feels oddly familiar - Krševan.

You can see Krsevan here.

>ask krsevan about laura
Krsevan seems irritated. He doesn't want to talk right now. He looks like he's in no mood for conversation. He tells you to talk with Laura, Nona, and Sarmelo.

>ask laura about s
Laura seems lost in thought. She doesn't seem to want to talk right now. Perhaps she's too focused on her cravings.

>ask laura about s
Laura seems lost in thought. She doesn't seem to want to talk right now. Perhaps she's too focused on her cravings.

>ask laura about s
Laura seems lost in thought. She doesn't seem to want to talk right now. Perhaps she's too focused on her cravings.

The sound of the clock grows louder and more insistent. You feel its ticking resonating in your mind, as if urging you to act. It is sooooo loud you need to go back to room (east) and turn it of
The sound of the clock becomes deafening. You feel an overwhelming urge to return to the Soba of Awakening. (east)

>go east
The dizziness overwhelms you, and you need a moment to steady yourself.

Soba of Awakening
You stagger back into the room, your head spinning. You feel dizzy, and the air seems to buzz around you. The room has changed. It looks much tidier and cleaner now, as though someone has spent a long time organizing it. The once-bare walls are now spotless, and the table is neatly arranged with a small, mysterious object on it. The clock ticks more softly, almost as if it's calming you. You wonder if everything that just happened was real.

You can see Nona computer, a wooden table and an antique clock here.

>look at table
On the table, you see a small, mysterious computer. Its screen flickers with strange symbols, and you wonder what purpose it serves. Something about it feels out of place, but it might hold the key to understanding what's happening here.

>look at computer
The computer's screen flickers erratically, displaying strange symbols, but when you look closer, it's a Ryanair ticket??? You take a better look and try to find something on the computer that will help you understand, and you see the time on the computer is 5.6.2019!!!! Are we a few days in the past???? And you can see that ticket is sent on email to NONAAA?!?!?!?
*Thinks*Hmmm, this room looks different. It has purple walls, and everything is purple. There are a lot of chocolates on the table and tiger prints?? Is this Nona's room? How is that possible? What is happening??

The sound of the clock grows louder and more insistent. You feel its ticking resonating in your mind, as if urging you to act. It is sooooo loud you need to go back to room (east) and turn it ofYou find yourself again in a nearly empty room. The walls are gray and bare. Its ticking echoes in your mind, strangely familiar yet distant.
What is happening room was purple with tiger print all around me.... and the clock was so lound but now it's quietI should ask Nona about this mybe she knows something

>go west
The Town Square
You step outside into the bustling town square. The air is filled with the sound of distant chatter and the smell of fresh bread from the bakery. In front of you, there are four people standing: three of them are strangers, and only one of them feels oddly familiar - Krševan.

You can see Sarmelo, Nona, Laura and Krsevan here.

>ask Nona about s
Nona tell me what is happening??.

 WHAT DODN'T YOU SEE I HAVE BETTER THINGS TO DO

>ask Nona about flight
Nona tell me what is happening??.

 WHAT DODN'T YOU SEE I HAVE BETTER THINGS TO DO

* * *

>go west
The Town Square
You step outside into the bustling town square. The air is filled with the sound of distant chatter and the smell of fresh bread from the bakery. In front of you, there are four people standing: three of them are strangers, and only one of them feels oddly familiar - Krševan.

You can see Krsevan here.

>ask krsevan about s
Krsevan seems irritated. He doesn't want to talk right now. He looks like he's in no mood for conversation. He tells you to talk with Laura, Nona, and Sarmelo.

>ask laura about s
Laura seems lost in thought. She doesn't seem to want to talk right now. Perhaps she's too focused on her cravings.

* * *

>look at computer
The computer's screen flickers erratically, displaying strange symbols, but when you look closer, it's a Ryanair ticket??? You take a better look and try to find something on the computer that will help you understand, and you see the time on the computer is 5.6.2019!!!! Are we a few days in the past???? And you can see that ticket is sent on email to NONAAA?!?!?!?
*Thinks*Hmmm, this room looks different. It has purple walls, and everything is purple. There are a lot of chocolates on the table and tiger prints?? Is this Nona's room? How is that possible? What is happening??

The sound of the clock grows louder and more insistent. You feel its ticking resonating in your mind, as if urging you to act. It is sooooo loud you need to go back to room (east) and turn it ofYou find yourself again in a nearly empty room. The walls are gray and bare. Its ticking echoes in your mind, strangely familiar yet distant.
What is happening room was purple with tiger print all around me.... and the clock was so lound but now it's quietI should ask Nona about this mybe she knows something

>go east
You can't go that way.

>go wast
You can't see any such thing.

>go west
The Town Square
You step outside into the bustling town square. The air is filled with the sound of distant chatter and the smell of fresh bread from the bakery. In front of you, there are four people standing: three of them are strangers, and only one of them feels oddly familiar - Krševan.

You can see Sarmelo, Nona, Laura and Krsevan here.

>ask nona about flight
WHAT HOW DO YOU KNOW ABOUT MY FLIGHT

>tell nona about flight
This provokes no reaction.

* * *

>go west
The Town Square
You step outside into the bustling town square. The air is filled with the sound of distant chatter and the smell of fresh bread from the bakery. In front of you, there are four people standing: three of them are strangers, and only one of them feels oddly familiar - Krševan.

You can see Krsevan here.

>ask krsevan about time
Krsevan seems irritated. He doesn't want to talk right now. He looks like he's in no mood for conversation. He tells you to talk with Laura, Nona, and Sarmelo.

>ask laura abou t
I didn't understand that sentence.

>ask laura abou t
I didn't understand that sentence.

>go east
Soba of Awakening
You find yourself in a nearly empty room. The walls are gray and bare. In the middle of the room stands an old wooden table with a single chair. Hanging on the wall is an antique clock. Its ticking echoes in your mind, strangely familiar yet distant. A vague memory lingers in your mind - the sensation of falling, and the surname "Krševean" echoes faintly in the distance, though you can't quite remember its significance.

You can see a wooden table and an antique clock here.

>look computer
You can't see any such thing.

>look at computer
You can't see any such thing.

>go west
The Town Square
You step outside into the bustling town square. The air is filled with the sound of distant chatter and the smell of fresh bread from the bakery. In front of you, there are four people standing: three of them are strangers, and only one of them feels oddly familiar - Krševan.

You can see Sarmelo, Nona, Laura and Krsevan here.

>ask laura about t
Laura seems lost in thought. She doesn't seem to want to talk right now. Perhaps she's too focused on her cravings.

>ask laura about t
Laura seems lost in thought. She doesn't seem to want to talk right now. Perhaps she's too focused on her cravings.

The sound of the clock grows louder and more insistent. You feel its ticking resonating in your mind, as if urging you to act. It is sooooo loud you need to go back to room (east) and turn it of
The sound of the clock becomes deafening. You feel an overwhelming urge to return to the Soba of Awakening. (east)

>go east
The dizziness overwhelms you, and you need a moment to steady yourself.

Soba of Awakening
You stagger back into the room, your head spinning. You feel dizzy, and the air seems to buzz around you. The room has changed. It looks much tidier and cleaner now, as though someone has spent a long time organizing it. The once-bare walls are now spotless, and the table is neatly arranged with a small, mysterious object on it. The clock ticks more softly, almost as if it's calming you. You wonder if everything that just happened was real.

You can see Nona computer, a wooden table and an antique clock here.

>look at computer
The computer's screen flickers erratically, displaying strange symbols, but when you look closer, it's a Ryanair ticket??? You take a better look and try to find something on the computer that will help you understand, and you see the time on the computer is 5.6.2019!!!! Are we a few days in the past???? And you can see that ticket is sent on email to NONAAA?!?!?!?
*Thinks*~~Hmmm, this room looks different. It has purple walls, and everything is purple. There are a lot of chocolates on the table and tiger prints?? Is this Nona's room? How is that possible? What is happening??~~
The sound of the clock grows louder and more insistent. You feel its ticking resonating in your mind, as if urging you to act. It is sooooo loud you need to go back to room (east) and turn it ofYou find yourself again in a nearly empty room. The walls are gray and bare. Its ticking echoes in your mind, strangely familiar yet distant.
What is happening room was purple with tiger print all around me.... and the clock was so lound but now it's quietI should ask Nona about this mybe she knows something

>go west
The Town Square
You step outside into the bustling town square. The air is filled with the sound of distant chatter and the smell of fresh bread from the bakery. In front of you, there are four people standing: three of them are strangers, and only one of them feels oddly familiar - Krševan.

You can see Sarmelo, Nona, Laura and Krsevan here.

>your ticket is on email
Nona: WHAT DO YOU KNO... Wait they are on my email... Well *rolls her eyes* that is relief
Nona: Wait what are you doing here in Varazdin?

 Player: Well... mmmm.... I am here to visit someone?!

 Nona: Oooo who??

 Player: Aren't you curious?

Player **thinks*~~Ok so I know that I am in Varazdin and what now... Nona is way to curious and I don't know should I trust her, best thing is to ignore her from now on and she is probably ready for pension fund~~
 Player **thinks**~~I should go and sleep to clear my mind. What happened today, why was the clock so loud and where was I in that purple room, did I go crazy?~~That's not a verb I recognise.

>go east
Soba of Awakening
You find yourself again in a nearly empty room. The walls are gray and bare. Its ticking echoes in your mind, strangely familiar yet distant.

You can see a wooden table and an antique clock here.

>sleep
Player fell asleep
 The sound of the clock grows louder and more insistent. You feel its ticking resonating in your mind, as if urging you to act. It wakes you up.

 Player: WHATTTT??? 
 What is happening... Why is everything so noisy? 
 Player: I should go and check what is happening in living room (north)
You aren't feeling especially drowsy.

>go north
Player: Why is Laura, Nona, Sarmelo and Krsevan here and what are they doing??? 
 It looks like they are playing some game... it that... catan and Krsevan is winning no wayyy 
 Player: I want to join and show you how to play catan. 
 After few minutes of playing I see Sarmelo with banana and laura favourit drink is pepsi and milk?? is that PILK??? disgusting, mybe she is craving PILK. 
 Wait what time is it where am I why is everyone so friendly right now with?? This is wierd I should ask what time it is

>ask laura about time
Laura: It's 21:20 1.7.2019.

 Player: What I am in FUTURE??? this is some wierd dream... oh at least I'll show them how to play catan.

 After playing and almost wining you stand up and feel a strange sensation of falling after which you wake up
 You are awake now you should probably look at you wierd power of thinking and see if something will help you with Laura, Krsevan or Sarmelo and ask what is happening

>go south
Soba of Awakening
You find yourself again in a nearly empty room. The walls are gray and bare. Its ticking echoes in your mind, strangely familiar yet distant.

You can see a wooden table and an antique clock here.

>go west
The Town Square
You step outside into the bustling town square. The air is filled with the sound of distant chatter and the smell of fresh bread from the bakery. In front of you, there are four people standing: three of them are strangers, and only one of them feels oddly familiar - Krševan.

You can see Krsevan, Sarmelo, Nona and Laura here.

>ask laura about what is happening
Laura: I don't know.. what do you mean?? you ok?? 
Choose answer: 
 1) No no I am ok just little bit tired
 2) I don't know what is happening I am lost... i have some wierd dreams and something is wrong like sometimes i feel like I am falling...

>1
Laura: Oh ok good I don't have time for you right know, I just have this wierd craving and I don't know for what?? Have any idea??
That's not a verb I recognise.

>pilk
Laura: OMG yes that's what I need that you soo much now I can buy what I need do you want something like fruit or something...??

 Player: *Thinks**~~Hmmmm fruit mybe Sarmelo would like to have fruit.... BANANA ~~ 
 Yes buy me banana
 Laura; Ok see you tomorrow
 

 Player: I should think about everything...

 After trying to piece everything together player head starts to heart and he can hear something???
The sound of the clock grows louder and more insistent. You feel its ticking resonating in your mind, as if urging you to act. You need to run and see that clockThat's not a verb I recognise.

>go east
Soba of Awakening
You find yourself again in a nearly empty room. The walls are gray and bare. Its ticking echoes in your mind, strangely familiar yet distant.

You can see a wooden table and an antique clock here.

Player: What is happening with this clock? I NEED TO SMASH IT, I CANNOT WITH THIS SOUND!

Weird noises: smash.... smash.... smash........

>smash
Player starts to feel wierd and everything is green....

Player; Why is everything soo green what is this turquoise green colour...

 Player: Are walls green ???? What in the h....

 You hear footesteps someone is coming in room...

 Krsevan enters the room.

 Krsevan: What are you doing here? This is my room!

 Player: But... everything's green!

 Krsevan: It's my style, deal with it.

 Player: It's... too much green.

 Krsevan: Get used to it.

Player **thinks*~~I shouled probably ask Krsevan what time it is??~~
What do you want to smash?

>ask krsevan about what is happening
Player starts to feel wierd and everything is green....

Player; Why is everything soo green what is this turquoise green colour...

 Player: Are walls green ???? What in the h....

 You hear footesteps someone is coming in room...

 Krsevan enters the room.

 Krsevan: What are you doing here? This is my room!

 Player: But... everything's green!

 Krsevan: It's my style, deal with it.

 Player: It's... too much green.

 Krsevan: Get used to it.

Player **thinks*~~I shouled probably ask Krsevan what time it is??~~

Krsevan: WHY ARE YOU CALLING ME BY MY LAST NAME?!?!?! YOU OK!!

Krsevan runs out of room and slams the door
 *Thinks*~~Huh what's up with him??? anyway let's explore room mybe I will understand what is happening (look)~~

>look
Soba of Awakening
Everything is just green, room is green probably because this is Krsevan's room

You can see Krsevan, a hidden banana, a hidden paper, a wooden table and an antique clock here.

>look banana
This banana has massage on it: "Sarmelo is crazy for bananas soo I will gift him one"

Player: ~~I feel dizzy... why is this green trying to attack me... damn green~~
You find yourself again in a nearly empty room. The walls are gray and bare. Its ticking echoes in your mind, strangely familiar yet distant.  
 you should probabaly go and see Laura

>look paper
Oh this is Krsevan test... *looks closely* ... OMG his name is not Krsevan it is Luka

>go west
The Town Square
You step outside into the bustling town square. The air is filled with the sound of distant chatter and the smell of fresh bread from the bakery. In front of you, there are four people standing: three of them are strangers, and only one of them feels oddly familiar - Krševan.

You can see Sarmelo, Nona and Laura here.

Player: Laura is back from shopping I should probably ask her about banana

>ask laura about banana
Laura: OOO Yeaa! Here you go
Laura gave you banana! Not you can gift it to someone
Laura: Yea bye the way, do you know what is with Luka? He look angry.... and because of that he doesn't want to play Catan :(
 Choose answer: 
 3) Oooo he is moody but I will se what I can do
 4)No 

Player: ~~I feel dizzy... why is this green trying to attack me... damn green~~
You find yourself again in a nearly empty room. The walls are gray and bare. Its ticking echoes in your mind, strangely familiar yet distant.  
 you should probabaly go and see Laura

Player: Laura is back from shopping I should probably ask her about banana

>3
Laura: Oh ok good I don't have time for Luka right know, but I am ready to win in Catan
Player *thinks* ~Why is everyone now ready for Catan does it connect somehow with that one wierd dream....~
Player *thinks* ~I should appology to Krsevan... I mean Luka about his name~That's not a verb I recognise.

>inventroy
That's not a verb I recognise.

>inventory
You are carrying nothing.

Player: Laura is back from shopping I should probably ask her about banana

* * *

>ask krsevan about time
Krsevan seems irritated. He doesn't want to talk right now. He looks like he's in no mood for conversation. He tells you to talk with Laura, Nona, and Sarmelo.

>ask laura about t
Laura seems lost in thought. She doesn't seem to want to talk right now. Perhaps she's too focused on her cravings.

>ask nona about t
Nona doesn't seem interested in talking right now, she's too focused on finding her lost tickets.

>ask sarmelo about t
Sarmelo seems too preoccupied to talk. He keeps muttering about needing to find some fruit.

The sound of the clock grows louder and more insistent. You feel its ticking resonating in your mind, as if urging you to act. It is sooooo loud you need to go back to room (east) and turn it of
The sound of the clock becomes deafening. You feel an overwhelming urge to return to the Soba of Awakening. (east)

>go east
The dizziness overwhelms you, and you need a moment to steady yourself.

Soba of Awakening
You stagger back into the room, your head spinning. You feel dizzy, and the air seems to buzz around you. The room has changed. It looks much tidier and cleaner now, as though someone has spent a long time organizing it. The once-bare walls are now spotless, and the table is neatly arranged with a small, mysterious object on it. The clock ticks more softly, almost as if it's calming you. You wonder if everything that just happened was real.

You can see Nona computer, a wooden table and an antique clock here.

* * *

>ask laura about time
Laura: It's 21:20 1.7.2019.

 Player: What I am in FUTURE??? this is some wierd dream... oh at least I'll show them how to play catan.

 After playing and almost wining you stand up and feel a strange sensation of falling after which you wake up
 You are awake now you should probably look at you wierd power of thinking and see if something will help you with Laura, Krsevan or Sarmelo and ask what is happening

>go west
You can't go that way.

>go south
Soba of Awakening
You find yourself again in a nearly empty room. The walls are gray and bare. Its ticking echoes in your mind, strangely familiar yet distant.

You can see a wooden table and an antique clock here.

* * *

>go west
The Town Square
You step outside into the bustling town square. The air is filled with the sound of distant chatter and the smell of fresh bread from the bakery. In front of you, there are four people standing: three of them are strangers, and only one of them feels oddly familiar - Krševan.

You can see Krsevan, Sarmelo, Nona and Laura here.

>ask laura what is happening
I didn't understand that sentence.

>ask laura about what is happening
Laura: I don't know.. what do you mean?? you ok?? 
Choose answer: 
 1) No no I am ok just little bit tired
 2) I don't know what is happening I am lost... i have some wierd dreams and something is wrong like sometimes i feel like I am falling...

* * *

>smash
Player starts to feel wierd and everything is green....

Player; Why is everything soo green what is this turquoise green colour...

 Player: Are walls green ???? What in the h....

 You hear footesteps someone is coming in room...

 Krsevan enters the room.

 Krsevan: What are you doing here? This is my room!

 Player: But... everything's green!

 Krsevan: It's my style, deal with it.

 Player: It's... too much green.

 Krsevan: Get used to it.

Player **thinks*~~I shouled probably ask Krsevan what time it is??~~
What do you want to smash?

>ask krsevan about what is happening
Player starts to feel wierd and everything is green....

Player; Why is everything soo green what is this turquoise green colour...

 Player: Are walls green ???? What in the h....

 You hear footesteps someone is coming in room...

 Krsevan enters the room.

 Krsevan: What are you doing here? This is my room!

 Player: But... everything's green!

 Krsevan: It's my style, deal with it.

 Player: It's... too much green.

 Krsevan: Get used to it.

Player **thinks*~~I shouled probably ask Krsevan what time it is??~~
There is no reply.

* * *

>ask krsevan about time
Krsevan seems irritated. He doesn't want to talk right now. He looks like he's in no mood for conversation. He tells you to talk with Laura, Nona, and Sarmelo.

>ask laura about time
Laura seems lost in thought. She doesn't seem to want to talk right now. Perhaps she's too focused on her cravings.

>ask laura about time
Laura seems lost in thought. She doesn't seem to want to talk right now. Perhaps she's too focused on her cravings.

>ask laura about time
Laura seems lost in thought. She doesn't seem to want to talk right now. Perhaps she's too focused on her cravings.

The sound of the clock grows louder and more insistent. You feel its ticking resonating in your mind, as if urging you to act. It is sooooo loud you need to go back to room (east) and turn it of
The sound of the clock becomes deafening. You feel an overwhelming urge to return to the Soba of Awakening. (east)

>go east
The dizziness overwhelms you, and you need a moment to steady yourself.

Soba of Awakening
You stagger back into the room, your head spinning. You feel dizzy, and the air seems to buzz around you. The room has changed. It looks much tidier and cleaner now, as though someone has spent a long time organizing it. The once-bare walls are now spotless, and the table is neatly arranged with a small, mysterious object on it. The clock ticks more softly, almost as if it's calming you. You wonder if everything that just happened was real.

You can see Nona computer, a wooden table and an antique clock here.

* * *

>go west
The Town Square
You step outside into the bustling town square. The air is filled with the sound of distant chatter and the smell of fresh bread from the bakery. In front of you, there are four people standing: three of them are strangers, and only one of them feels oddly familiar - Krševan.

You can see Sarmelo, Nona, Laura, Krsevan and now the banana here.

>your flight ticket is on email
That's not a verb I recognise.

>your ticket is on email
Nona: WHAT DO YOU KNO... Wait they are on my email... Well *rolls her eyes* that is relief
Nona: Wait what are you doing here in Varazdin?

 Player: Well... mmmm.... I am here to visit someone?!

 Nona: Oooo who??

 Player: Aren't you curious?

Player **thinks*~~Ok so I know that I am in Varazdin and what now... Nona is way to curious and I don't know should I trust her, best thing is to ignore her from now on and she is probably ready for pension fund~~
 Player **thinks**~~I should go and sleep to clear my mind. What happened today, why was the clock so loud and where was I in that purple room, did I go crazy?~~That's not a verb I recognise.

* * *

>go west
The Town Square
You step outside into the bustling town square. The air is filled with the sound of distant chatter and the smell of fresh bread from the bakery. In front of you, there are four people standing: three of them are strangers, and only one of them feels oddly familiar - Krševan.

You can see Krsevan, Sarmelo, Nona and Laura here.

>ask Laura about what is happening
Laura: I don't know.. what do you mean?? you ok?? 
Choose answer: 
 1) No no I am ok just little bit tired
 2) I don't know what is happening I am lost... i have some wierd dreams and something is wrong like sometimes i feel like I am falling...

>1
Laura: Oh ok good I don't have time for you right know, I just have this wierd craving and I don't know for what?? Have any idea??
That's not a verb I recognise.

* * *

>banana
That's not a verb I recognise.

>go east
Soba of Awakening
You find yourself again in a nearly empty room. The walls are gray and bare. Its ticking echoes in your mind, strangely familiar yet distant.

You can see a wooden table and an antique clock here.

>go east
You can't go that way.

>go west
The Town Square
You step outside into the bustling town square. The air is filled with the sound of distant chatter and the smell of fresh bread from the bakery. In front of you, there are four people standing: three of them are strangers, and only one of them feels oddly familiar - Krševan.

You can see Krsevan, Sarmelo, Nona and Laura here.

>go east
Soba of Awakening
You find yourself again in a nearly empty room. The walls are gray and bare. Its ticking echoes in your mind, strangely familiar yet distant.

You can see a wooden table and an antique clock here.

>destory
That's not a verb I recognise.

>destroy
Player starts to feel wierd and everything is green....

Player; Why is everything soo green what is this turquoise green colour...

 Player: Are walls green ???? What in the h....

 You hear footesteps someone is coming in room...

 Krsevan enters the room.

 Krsevan: What are you doing here? This is my room!

 Player: But... everything's green!

 Krsevan: It's my style, deal with it.

 Player: It's... too much green.

 Krsevan: Get used to it.

Player **thinks*~~I shouled probably ask Krsevan what time it is??~~
What do you want to destroy?

>look
Player starts to feel wierd and everything is green....

Player; Why is everything soo green what is this turquoise green colour...

 Player: Are walls green ???? What in the h....

 You hear footesteps someone is coming in room...

 Krsevan enters the room.

 Krsevan: What are you doing here? This is my room!

 Player: But... everything's green!

 Krsevan: It's my style, deal with it.

 Player: It's... too much green.

 Krsevan: Get used to it.

Player **thinks*~~I shouled probably ask Krsevan what time it is??~~
Soba of Awakening
You find yourself again in a nearly empty room. The walls are gray and bare. Its ticking echoes in your mind, strangely familiar yet distant.

You can see a wooden table and an antique clock here.

>look at paper
You can't see any such thing.

>look at hidden paper
You can't see any such thing.

* * *

>go west
The Town Square
You step outside into the bustling town square. The air is filled with the sound of distant chatter and the smell of fresh bread from the bakery. In front of you, there are four people standing: three of them are strangers, and only one of them feels oddly familiar - Krševan.

You can see Sarmelo, Nona, Laura, Krsevan and now the banana here.

>your ticket is on email
Nona: WHAT DO YOU KNO... Wait they are on my email... Well *rolls her eyes* that is relief
Nona: Wait what are you doing here in Varazdin?

 Player: Well... mmmm.... I am here to visit someone?!

 Nona: Oooo who??

 Player: Aren't you curious?

Player **thinks*~~Ok so I know that I am in Varazdin and what now... Nona is way to curious and I don't know should I trust her, best thing is to ignore her from now on and she is probably ready for pension fund~~
 Player **thinks**~~I should go and sleep to clear my mind. What happened today, why was the clock so loud and where was I in that purple room, did I go crazy?~~That's not a verb I recognise.

* * *

>sleep
Player fell asleep
 The sound of the clock grows louder and more insistent. You feel its ticking resonating in your mind, as if urging you to act. It wakes you up.

 Player: WHATTTT??? 
 What is happening... Why is everything so noisy? 
 Player: I should go and check what is happening in living room (north)
You aren't feeling especially drowsy.

>go south
You can't go that way.

>ask laura about time
You can't see any such thing.

>go  north
Player: Why is Laura, Nona, Sarmelo and Krsevan here and what are they doing??? 
 It looks like they are playing some game... it that... catan and Krsevan is winning no wayyy 
 Player: I want to join and show you how to play catan. 
 After few minutes of playing I see Sarmelo with banana and laura favourit drink is pepsi and milk?? is that PILK??? disgusting, mybe she is craving PILK. 
 Wait what time is it where am I why is everyone so friendly right now with?? This is wierd I should ask what time it is

>ask laura about time
Laura: It's 21:20 1.7.2019.

 Player: What I am in FUTURE??? this is some wierd dream... oh at least I'll show them how to play catan.

 After playing and almost wining you stand up and feel a strange sensation of falling after which you wake up
 You are awake now you should probably look at you wierd power of thinking and see if something will help you with Laura, Krsevan or Sarmelo and ask what is happening

* * *

>go south
Soba of Awakening
You find yourself again in a nearly empty room. The walls are gray and bare. Its ticking echoes in your mind, strangely familiar yet distant.

You can see a wooden table and an antique clock here.

>go west
The Town Square
You step outside into the bustling town square. The air is filled with the sound of distant chatter and the smell of fresh bread from the bakery. In front of you, there are four people standing: three of them are strangers, and only one of them feels oddly familiar - Krševan.

You can see Krsevan, Sarmelo, Nona, Laura and now the banana here.

>ask laura abotu what is happening
I didn't understand that sentence.

>ask laura about what is happening
Laura: I don't know.. what do you mean?? you ok?? 
Choose answer: 
 1) No no I am ok just little bit tired
 2) I don't know what is happening I am lost... i have some wierd dreams and something is wrong like sometimes i feel like I am falling...

* * *

>1
Laura: Oh ok good I don't have time for you right know, I just have this wierd craving and I don't know for what?? Have any idea??
That's not a verb I recognise.

>ask laura about banana
Laura: OOO Yeaa! Here you go
Laura gave you banana! Not you can gift it to someone
Laura: Yea bye the way, do you know what is with Luka? He look angry.... and because of that he doesn't want to play Catan :(
 Choose answer: 
 3) Oooo he is moody but I will se what I can do
 4)No 

Player: ~~I feel dizzy... why is this green trying to attack me... damn green~~
You find yourself again in a nearly empty room. The walls are gray and bare. Its ticking echoes in your mind, strangely familiar yet distant.  
 you should probabaly go and see Laura

Player: Laura is back from shopping I should probably ask her about banana

>inventory
You are carrying nothing.

Player: Laura is back from shopping I should probably ask her about banana

>take banana
Taken.

Player: ~~I feel dizzy... why is this green trying to attack me... damn green~~
You find yourself again in a nearly empty room. The walls are gray and bare. Its ticking echoes in your mind, strangely familiar yet distant.  
 you should probabaly go and see Laura

Player: Laura is back from shopping I should probably ask her about banana

>luka
Luka: Ohhh soo you are now done with that joke... ok...

Luka: Now that I am happy we can go and play Catan. I will show you how to win
 Player: Yea like you would win anyway
 Player *thinks* Ok so now I just need to ask Sarmelo if he wants to play Catan.
That's not a verb I recognise.

>ask sarmelo about catan
Sarmelo: No, I need something!!!

Player: Laura is back from shopping I should probably ask her about banana

>inventory
You are carrying:
  now the banana

Player: Laura is back from shopping I should probably ask her about banana

* * *

>ask krsevan about time
Krsevan seems irritated. He doesn't want to talk right now. He looks like he's in no mood for conversation. He tells you to talk with Laura, Nona, and Sarmelo.

>ask nona about t
Nona doesn't seem interested in talking right now, she's too focused on finding her lost tickets.

>ask nona about t
Nona doesn't seem interested in talking right now, she's too focused on finding her lost tickets.

>ask nona about t
Nona doesn't seem interested in talking right now, she's too focused on finding her lost tickets.

The sound of the clock grows louder and more insistent. You feel its ticking resonating in your mind, as if urging you to act. It is sooooo loud you need to go back to room (east) and turn it of
The sound of the clock becomes deafening. You feel an overwhelming urge to return to the Soba of Awakening. (east)

>go east
The dizziness overwhelms you, and you need a moment to steady yourself.

Soba of Awakening
You stagger back into the room, your head spinning. You feel dizzy, and the air seems to buzz around you. The room has changed. It looks much tidier and cleaner now, as though someone has spent a long time organizing it. The once-bare walls are now spotless, and the table is neatly arranged with a small, mysterious object on it. The clock ticks more softly, almost as if it's calming you. You wonder if everything that just happened was real.

You can see Nona computer, a wooden table and an antique clock here.

* * *

>go west
The Town Square
You step outside into the bustling town square. The air is filled with the sound of distant chatter and the smell of fresh bread from the bakery. In front of you, there are four people standing: three of them are strangers, and only one of them feels oddly familiar - Krševan.

You can see Sarmelo, Nona, Laura and Krsevan here.

>ask laura about what is happening
Laura: I don't know.. what do you mean?? you ok?? 
Choose answer: 
 1) No no I am ok just little bit tired
 2) I don't know what is happening I am lost... i have some wierd dreams and something is wrong like sometimes i feel like I am falling...

* * *

>look
Soba of Awakening
You find yourself again in a nearly empty room. The walls are gray and bare. Its ticking echoes in your mind, strangely familiar yet distant.

You can see Krsevan, a hidden banana, a hidden paper, a wooden table and an antique clock here.

>look at paper
Oh this is Krsevan test... *looks closely* ... OMG his name is not Krsevan it is Luka

>look at banana
Ova banana ima poruku urezanu na sebi: "Sarmelo je lud za bananama!"

Player: ~~I feel dizzy... why is this green trying to attack me... damn green, blue is much nicer color~~

* * *

>go west
The Town Square
You step outside into the bustling town square. The air is filled with the sound of distant chatter and the smell of fresh bread from the bakery. In front of you, there are four people standing: three of them are strangers, and only one of them feels oddly familiar - Krševan.

You can see Krsevan here.

>ask krsevan about town
Krsevan seems irritated. He doesn't want to talk right now. He looks like he's in no mood for conversation. He tells you to talk with Laura, Nona, and Sarmelo.

>ask laura
What do you want to ask Laura for?

>ask laura about town
Laura seems lost in thought. She doesn't seem to want to talk right now. Perhaps she's too focused on her cravings.

>ask laura about town
Laura seems lost in thought. She doesn't seem to want to talk right now. Perhaps she's too focused on her cravings.

>go east
Soba of Awakening
You find yourself in a nearly empty room. The walls are gray and bare. In the middle of the room stands an old wooden table with a single chair. Hanging on the wall is an antique clock. Its ticking echoes in your mind, strangely familiar yet distant. A vague memory lingers in your mind - the sensation of falling, and the surname "Krševean" echoes faintly in the distance, though you can't quite remember its significance.

You can see a wooden table and an antique clock here.

>go west
The Town Square
You step outside into the bustling town square. The air is filled with the sound of distant chatter and the smell of fresh bread from the bakery. In front of you, there are four people standing: three of them are strangers, and only one of them feels oddly familiar - Krševan.

You can see Sarmelo, Nona, Laura and Krsevan here.

>ask laura about town
Laura seems lost in thought. She doesn't seem to want to talk right now. Perhaps she's too focused on her cravings.

The sound of the clock grows louder and more insistent. You feel its ticking resonating in your mind, as if urging you to act. It is sooooo loud you need to go back to room (east) and turn it of
The sound of the clock becomes deafening. You feel an overwhelming urge to return to the Soba of Awakening. (east)

>go east
The dizziness overwhelms you, and you need a moment to steady yourself.

Soba of Awakening
You stagger back into the room, your head spinning. You feel dizzy, and the air seems to buzz around you. The room has changed. It looks much tidier and cleaner now, as though someone has spent a long time organizing it. The once-bare walls are now spotless, and the table is neatly arranged with a small, mysterious object on it. The clock ticks more softly, almost as if it's calming you. You wonder if everything that just happened was real.

You can see Nona computer, a wooden table and an antique clock here.

* * *

>go east
You can't go that way.

>go north
You can't go north yet. Something is blocking your way.

>go west
The Town Square
You step outside into the bustling town square. The air is filled with the sound of distant chatter and the smell of fresh bread from the bakery. In front of you, there are four people standing: three of them are strangers, and only one of them feels oddly familiar - Krševan.

You can see Sarmelo, Nona, Laura and Krsevan here.

>ask Nona about flight
Nona: WHAT HOW DO YOU KNOW ABOUT MY FLIGHT
*Thinkss* ~~Mybe I should ask her why is she stressed or mybe I should say her to chill down~~**thinks*

>your ticket is on email
Nona: WHAT DO YOU KNO... Wait they are on my email... Well *rolls her eyes* that is relief
Nona: Wait what are you doing here in Varazdin?

 Player: Well... mmmm.... I am here to visit someone?!

 Nona: Oooo who??

 Player: Aren't you curious?

Player **thinks*~~Ok so I know that I am in Varazdin and what now... Nona is way to curious and I don't know should I trust her, best thing is to ignore her from now on and she is probably ready for pension fund~~
 Player **thinks**~~I should go and sleep to clear my mind. What happened today, why was the clock so loud and where was I in that purple room, did I go crazy?~~That's not a verb I recognise.

* * *

>go north
Player: Why is Laura, Nona, Sarmelo and Krsevan here and what are they doing??? 
 It looks like they are playing some game... it that... catan and Krsevan is winning no wayyy 
 Player: I want to join and show you how to play catan. 
 After few minutes of playing I see Sarmelo with banana and laura favourit drink is pepsi and milk?? is that PILK??? disgusting, mybe she is craving PILK. 
 Wait what time is it where am I why is everyone so friendly right now with?? This is wierd I should ask what time it is

>ask nona about time
Nona: I don't know, am I late for something???.

>ask sarmelo about time
Sarmelo: Same as yesterday at this time.

>ask laura about time
Laura: It's 21:20 1.7.2019.

 Player: What I am in FUTURE??? this is some wierd dream... oh at least I'll show them how to play catan.

 After playing and almost wining you stand up and feel a strange sensation of falling after which you wake up
 You are awake now you should probably look at you wierd power of thinking and see if something will help you with Laura, Krsevan or Sarmelo and ask what is happening

* * *

>go west
The Town Square
You step outside into the bustling town square. The air is filled with the sound of distant chatter and the smell of fresh bread from the bakery. In front of you, there are four people standing: three of them are strangers, and only one of them feels oddly familiar - Krševan.

You can see Krsevan, Sarmelo, Nona and Laura here.

>ask Laura about town
There is no reply.

>what is happening
That's not a verb I recognise.

>ask laura what is happening
I didn't understand that sentence.

* * *

>ask laura about what is happening
Laura: I don't know.. what do you mean?? you ok?? 
Choose answer: 
 1) No no I am ok just little bit tired
 2) I don't know what is happening I am lost... i have some wierd dreams and something is wrong like sometimes i feel like I am falling...

>2
Laura: OKKKKEEYYY you wierdo, go home and take your problems with yourself I am not psychologist pfffffThat's not a verb I recognise.

>1
Laura: Oh ok good I don't have time for you right know, I just have this wierd craving and I don't know for what?? Have any idea??
That's not a verb I recognise.

>PILK
Laura: OMG yes that's what I need that you soo much now I can buy what I need do you want something like fruit or something...??

 Player: *Thinks**~~Hmmmm fruit mybe Sarmelo would like to have fruit.... BANANA ~~ 
 Yes buy me banana
 Laura; Ok see you tomorrow
 

 Player: I should think about everything...

 After trying to piece everything together player head starts to heart and he can hear something???
The sound of the clock grows louder and more insistent. You feel its ticking resonating in your mind, as if urging you to act. You need to run and see that clockThat's not a verb I recognise.

>go east
Soba of Awakening
You find yourself again in a nearly empty room. The walls are gray and bare. Its ticking echoes in your mind, strangely familiar yet distant.

You can see a wooden table and an antique clock here.

>destroy
Player starts to feel wierd and everything is green....

Player; Why is everything soo green what is this turquoise green colour...

 Player: Are walls green ???? What in the h....

 You hear footesteps someone is coming in room...

 Krsevan enters the room.

 Krsevan: What are you doing here? This is my room!

 Player: But... everything's green!

 Krsevan: It's my style, deal with it.

 Player: It's... too much green.

 Krsevan: Get used to it.

Player **thinks*~~I shouled probably ask Krsevan what time it is??~~
What do you want to destroy?

* * *

>ask krsevan about town
Krsevan seems irritated. He doesn't want to talk right now. He looks like he's in no mood for conversation. He tells you to talk with Laura, Nona, and Sarmelo.

>ask laura about s
Laura seems lost in thought. She doesn't seem to want to talk right now. Perhaps she's too focused on her cravings.

* * *

>go west
The Town Square
You step outside into the bustling town square. The air is filled with the sound of distant chatter and the smell of fresh bread from the bakery. In front of you, there are four people standing: three of them are strangers, and only one of them feels oddly familiar - Krševan.

You can see Sarmelo, Nona, Laura and Krsevan here.

>ask nona about flight
Nona: WHAT HOW DO YOU KNOW ABOUT MY FLIGHT
*Thinkss* ~~Mybe I should ask her why is she stressed or mybe I should say her to chill down~~**thinks*

>chill down
Nona: LEAVE ME ALONEEEThat's not a verb I recognise.

>why are you stressed
Nona: I lost my ticket to Finland and I don't know what to do*Thinkss*That's not a verb I recognise.

>your ticket is on email
Nona: WHAT DO YOU KNO... Wait they are on my email... Well *rolls her eyes* that is relief
Nona: Wait what are you doing here in Varazdin?

 Player: Well... mmmm.... I am here to visit someone?!

 Nona: Oooo who??

 Player: Aren't you curious?

Player **thinks*~~Ok so I know that I am in Varazdin and what now... Nona is way to curious and I don't know should I trust her, best thing is to ignore her from now on and she is probably ready for pension fund~~
 Player **thinks**~~I should go and sleep to clear my mind. What happened today, why was the clock so loud and where was I in that purple room, did I go crazy?~~That's not a verb I recognise.

* * *

>go north
Player: Why is Laura, Nona, Sarmelo and Krsevan here and what are they doing??? 
 It looks like they are playing some game... it that... catan and Krsevan is winning no wayyy 
 Player: I want to join and show you how to play catan. 
 After few minutes of playing I see Sarmelo with banana and laura favourit drink is pepsi and milk?? is that PILK??? disgusting, mybe she is craving PILK. 
 Wait what time is it where am I why is everyone so friendly right now with?? This is wierd I should ask what time it is

>ask laura about time
Laura seems lost in thought. She doesn't seem to want to talk right now. Perhaps she's too focused on her cravings.

>ask nona about time
Nona: I don't know, am I late for something???.

* * *

>ask laura about s
Laura seems lost in thought. She doesn't seem to want to talk right now. Perhaps she's too focused on her cravings.

>ask nona about s
Nona doesn't seem interested in talking right now, she's too focused on finding her lost tickets.

>ask sarmelo about d
Sarmelo seems too preoccupied to talk. He keeps muttering about needing to find some fruit.

The sound of the clock grows louder and more insistent. You feel its ticking resonating in your mind, as if urging you to act. It is sooooo loud you need to go back to room (east) and turn it of
The sound of the clock becomes deafening. You feel an overwhelming urge to return to the Soba of Awakening. (east)
Nona is no longer willing to talk to you

* * *

>ask laura about t
Laura seems lost in thought. She doesn't seem to want to talk right now. Perhaps she's too focused on her cravings.

The sound of the clock grows louder and more insistent. You feel its ticking resonating in your mind, as if urging you to act. It is so loud that you need to go back to the room (east) and turn it off
The sound of the clock becomes deafening. You feel an overwhelming urge to return to the Soba of Awakening. (east)

>go east
The dizziness overwhelms you, and you need a moment to steady yourself.

Soba of Awakening
You stagger back into the room, your head spinning. You feel dizzy, and the air seems to buzz around you. The room has changed. It looks much tidier and cleaner now, as though someone has spent a long time organizing it. The once-bare walls are now spotless, and the table is neatly arranged with a small, mysterious object on it. The clock ticks more softly, almost as if it's calming you. You wonder if everything that just happened was real.

You can see Nona computer, a wooden table and an antique clock here.

>look at computer
The computer's screen flickers erratically, displaying strange symbols, but when you look closer, it's a Ryanair ticket??? You take a better look and try to find something on the computer that will help you understand, and you see the time on the computer is 5.6.2019!!!! Are we a few days in the past???? And you can see that ticket is sent on email to NONAAA?!?!?!?

* * *

>[enter]
You find yourself again in a nearly empty room. The walls are gray and bare. Its ticking echoes in your mind, strangely familiar yet distant.

>[enter]
What is happening room was purple with tiger print all around me.... and the clock was so lound but now it's quiet
I should ask Nona about this mybe she knows something

>go west
The Town Square
You step outside into the bustling town square. The air is filled with the sound of distant chatter and the smell of fresh bread from the bakery. In front of you, there are four people standing: three of them are strangers, and only one of them feels oddly familiar - Krševan.

You can see Sarmelo, Nona, Laura and Krsevan here.

>ask nona about flight
Nona: WHAT HOW DO YOU KNOW ABOUT MY FLIGHT

>[enter]
*Thinkss* ~~Maybe I should ask her why she is stressed or mybe I should tell her to chill down~~**thinks*

I beg your pardon?

>your ticket is on email
Nona: WHAT DO YOU KNO... Wait they are on my email... Well *rolls her eyes* that is a relief

>[enter]
Nona: Wait what are you doing here in Varazdin?

* * *

>[enter]
Player **thinks*~~Okay, so I know that I am in Varaždin, and now what... Nona is way too curious, and I don't know whether I should trust her. The best thing is to ignore her from now on, and she's probably ready for the pension fund.~~

>[enter]
Player **thinks**~~I should go to sleep to clear my mind. What happened today? Why was the clock so loud, and where was I in that purple room? Did I go crazy?~~That's not a verb I recognise.

>go east
Soba of Awakening

 You find yourself again in a nearly empty room. The walls are gray and bare. Its ticking echoes in your mind, strangely familiar yet distant.

You can see a wooden table and an antique clock here.

>sleep
Player fell asleep
 The sound of the clock grows louder and more insistent. You feel its ticking resonating in your mind, as if urging you to act. It wakes you up.

>g
Player: WHATTTT??? 
 What is happening... Why is everything so noisy? 
(new place unlocked: living room) 
 Player: I should go and check what is happening in living room (north)
You aren't feeling especially drowsy.

>go north
Player: Why is Laura, Nona, Sarmelo and Krsevan here and what are they doing???

>[enter]
It looks like they are playing some game... is that... catan and Krsevan is winning... no wayyy

>[enter]
Player: I want to join and show you how to play catan.

>[enter]
After a few minutes of playing, I see Sarmelo with a banana, and Laura's favorite drink is Pepsi and milk?? Is that PILK??? Disgusting, maybe she's craving PILK. 
 Wait, what time is it? Where am I? Why is everyone so friendly right now? This is weird. I should ask what time it is.

* * *

>[enter]
You are awake now you should probably look at you wierd power of thinking and see if something will help you with Laura, Krsevan or Sarmelo and ask what is happening

>go west
The Town Square
You step outside into the bustling town square. The air is filled with the sound of distant chatter and the smell of fresh bread from the bakery. In front of you, there are four people standing: three of them are strangers, and only one of them feels oddly familiar - Krševan.

You can see Krsevan, Sarmelo, Nona and Laura here.

>ask laura about what is happening
Laura: I don't know.. what do you mean?? you ok??

* * *

>[enter]
Choose answer: 
 1) No no I am ok just little bit tired
 2) I don't know what is happening I am lost... I have some wierd dreams and something is wrong, sometimes I feel like I am falling... and that falling is always with me!!!

I beg your pardon?

>1
Laura: Oh, okay, good. I don't have time for you right now. I just have this weird craving and I don't know for what. Any idea??
That's not a verb I recognise.

>pilk
Laura: OMG, yes, that's exactly what I need! Thank you so much. Now I can buy what I need. Do you want something, like fruit or something...?

>[enter]
Player: *Thinks**~~Hmmmm fruit maybe Sarmelo would like to have fruit.... BANANA ~~ 
 Yes buy me banana

>[enter]
Laura; Ok see you tomorrow

* * *

>[enter]
The sound of the clock grows louder and more insistent. You feel its ticking resonating in your mind, as if urging you to act. You need to run and see that clockThat's not a verb I recognise.

>go east
Soba of Awakening

 You find yourself again in a nearly empty room. The walls are gray and bare. Its ticking echoes in your mind, strangely familiar yet distant.

You can see a wooden table and an antique clock here.

Player: What is happening with this clock? I NEED TO SMASH IT, I CANNOT WITH THIS SOUND!

Weird noises: smash.... smash.... smash........

>smash
Player starts to feel wierd and everything is green....

* * *

>[enter]
Player: It's... too much green.

 Krsevan: Get used to it.

>[enter]
Player **thinks*~~I shouled probably ask Krsevan what is happening??~~
What do you want to smash?

>ask krsevan about what is happening
Player starts to feel wierd and everything is green....

>[enter]
Player; Why is everything soo green what is this turquoise green colour...

* * *

>[enter]
Player: It's... too much green.

 Krsevan: Get used to it.

>[enter]
Player **thinks*~~I shouled probably ask Krsevan what is happening??~~

Krsevan: WHY ARE YOU CALLING ME BY MY LAST NAME?!?!?! YOU OK!!

Krsevan runs out of room and slams the door

>[enter]
*Thinks*~~Huh, what's up with him??? Anyway, let's explore the room. Maybe I will understand what is happening. (look)~~

>look at paper
Oh this is Krsevan test... *looks closely* ... OMG his name is not Krsevan it is Luka

I beg your pardon?

* * *

>[enter]
You find yourself again in a nearly empty room. The walls are gray and bare. Its ticking echoes in your mind, strangely familiar yet distant.

>[enter]
You should probably go and see Laura

I beg your pardon?

>go west
The Town Square
You step outside into the bustling town square. The air is filled with the sound of distant chatter and the smell of fresh bread from the bakery. In front of you, there are four people standing: three of them are strangers, and only one of them feels oddly familiar - Krševan.

You can see Sarmelo, Nona and Laura here.

Player: Laura is back from shopping. I should probably ask her about the banana.

>ask laura about banana
Laura: OOO Yeaa! Take it (Type take hidden banana)

Player: ~~I feel dizzy... why is this green so overwhelming... damn, the green~~

* * *

>[enter]
You find yourself again in a nearly empty room. The walls are gray and bare. Its ticking echoes in your mind, strangely familiar yet distant.

>[enter]
You should probably go and see Laura

Player: Laura is back from shopping. I should probably ask her about the banana.

>take hidden banana
Laura gave you banana! Now you can gift it to someone.

>[enter]
Laura: By the way, do you know what's up with Luka? He looks angry... and because of that, he doesn't want to play Catan. :(

>[enter]
Choose answer: 
 3) Oooo, he is moody but I will see what I can do
 4) No 
Taken.

Player: ~~I feel dizzy... why is this green so overwhelming... damn, the green~~

>2
You find yourself again in a nearly empty room. The walls are gray and bare. Its ticking echoes in your mind, strangely familiar yet distant.

>3
You should probably go and see Laura

Player: Laura is back from shopping. I should probably ask her about the banana.

>3
Laura: Oh, okay, good. I don't have time for Luka right now, but I'm ready to win at Catan!

Player *thinks* ~Why is everyone ready for Catan now? Does it somehow connect with that one weird dream..~

>[enter]
Player *thinks* ~I should apologize to Krsevan... I mean Luka, about his name.~ (call krsevan by his name)That's not a verb I recognise.

>luka
Luka: Ohhh soo you are now done with that joke... ok...

>[enter]
Luka: Now that I am happy we can go and play Catan. I will show you how to win
 Player: Yea like you would win anyway

>[enter]
Player *thinks* Ok so now I just need to ask Sarmelo if he wants to play Catan.That's not a verb I recognise.

>ask sarmelo about time
Sarmelo: Same as yesterday at this time.

Player: Laura is back from shopping. I should probably ask her about the banana.

I beg your pardon?

>ask sarmelo about town
There is no reply.

Player: Laura is back from shopping. I should probably ask her about the banana.

>ask sarmelo about banana
There is no reply.

Player: ~~I feel dizzy... why is this green so overwhelming... damn, the green~~

>[enter]
You find yourself again in a nearly empty room. The walls are gray and bare. Its ticking echoes in your mind, strangely familiar yet distant.

* * *

>[enter]
You should probably go and see Laura

Player: Laura is back from shopping. I should probably ask her about the banana.

>give sarmelo banana
(first taking the hidden banana)

Sarmelo takes the banana and starts eating it with great satisfaction.

>[enter]
Sarmelo: "Ah, this is the best banana ever! Thank you, you've saved me."

Player should probably now go and rest for second (move to east)

Player: ~~I feel dizzy... why is this green so overwhelming... damn, the green~~

>[enter]
You find yourself again in a nearly empty room. The walls are gray and bare. Its ticking echoes in your mind, strangely familiar yet distant.

* * *

>[enter]
You should probably go and see Laura

Player: Laura is back from shopping. I should probably ask her about the banana.

>go east
Now everyone is happy and waiting for me to play catan.

 Player moves to living room where everyone is playing catan but everything feels similar
 Player thinks ~is this deja vu!?~
Living Room
A cozy living room with a sofa and a small coffee table. The air smells faintly of lavender.

 After playing for 30 min player is going to win... but when all of a sudden the player slipps from SARMEL'S BANANA PEEL AND STARTS TO FALL

>[enter]
Player hits his head hard on the floor....

>[enter]
You feel dizzy trie to move (type "restart" to regain your senses).

You can't go that way.

>restart
Now everyone is happy and waiting for me to play catan.

 Player moves to living room where everyone is playing catan but everything feels similar
 Player thinks ~is this deja vu!?~
Living Room
A cozy living room with a sofa and a small coffee table. The air smells faintly of lavender.

You can see Krsevan, Sarmelo, Nona and Laura here.

 After playing for 30 min player is going to win... but when all of a sudden the player slipps from SARMEL'S BANANA PEEL AND STARTS TO FALL

>[enter]
Player hits his head hard on the floor....

>[enter]
You feel dizzy trie to move (type "restart" to regain your senses).

Are you sure you want to restart?

Please answer yes or no.

>y
Welcome
An Interactive Fiction
Release 1 / Serial number 250110 / Inform 7 v10.1.2 / D

Soba of Awakening
You find yourself in a nearly empty room. The walls are gray and bare. In the middle of the room stands an old wooden table with a single chair. Hanging on the wall is an antique clock, its ticking echoing in your mind-strangely familiar yet distant. A vague memory lingers: the sensation of falling. This is something you will never forget, and the surname "Krševean" echoes faintly in the distance, though you can't quite remember its significance.

You can see a wooden table and an antique clock here.

* * *

>look at computer
The computer's screen flickers erratically, displaying strange symbols, but when you look closer, it's a Ryanair ticket??? You take a better look and try to find something on the computer that will help you understand, and you see the time on the computer is 5.6.2019!!!! Are we a few days in the past???? And you can see that ticket is sent on email to NONAAA?!?!?!?

>go east
You can't go that way.

>go west
The Town Square
You step outside into the bustling town square. The air is filled with the sound of distant chatter and the smell of fresh bread from the bakery. In front of you, there are four people standing: three of them are strangers, and only one of them feels oddly familiar - Krševan.

You can see Sarmelo, Nona, Laura and Krsevan here.

* * *

>ask nona about flight
Nona: WHAT HOW DO YOU KNOW ABOUT MY FLIGHT
*Thinkss* ~~Mybe I should ask her why is she stressed or mybe I should say her to chill down~~**thinks*

>your ticket is in email
That's not a verb I recognise.

>power of thinking
Your insight is: Nona's flight tickets are on emailThat's not a verb I recognise.

>your ticket is on email
Nona: WHAT DO YOU KNO... Wait they are on my email... Well *rolls her eyes* that is relief
Nona: Wait what are you doing here in Varazdin?

 Player: Well... mmmm.... I am here to visit someone?!

 Nona: Oooo who??

 Player: Aren't you curious?

Player **thinks*~~Ok so I know that I am in Varazdin and what now... Nona is way to curious and I don't know should I trust her, best thing is to ignore her from now on and she is probably ready for pension fund~~
 Player **thinks**~~I should go and sleep to clear my mind. What happened today, why was the clock so loud and where was I in that purple room, did I go crazy?~~That's not a verb I recognise.

* * *

>ask nona about time
Nona: I don't know, am I late for something???.

>ask laura about time
Laura: It's 21:20 1.7.2019.

 Player: What I am in FUTURE??? this is some wierd dream... oh at least I'll show them how to play catan.

 After playing and almost wining you stand up and feel a strange sensation of falling after which you wake up
 You are awake now you should probably look at you wierd power of thinking and see if something will help you with Laura, Krsevan or Sarmelo and ask what is happening

>look
Living Room
A cozy living room with a sofa and a small coffee table. The air smells faintly of lavender.

>go south
Soba of Awakening
You find yourself again in a nearly empty room. The walls are gray and bare. Its ticking echoes in your mind, strangely familiar yet distant.

You can see a wooden table and an antique clock here.

* * *

>go west
The Town Square
You step outside into the bustling town square. The air is filled with the sound of distant chatter and the smell of fresh bread from the bakery. In front of you, there are four people standing: three of them are strangers, and only one of them feels oddly familiar - Krševan.

You can see Krsevan, Sarmelo, Nona and Laura here.

>ask Laura about food
There is no reply.

>ask Laura about what is happening
Laura: I don't know.. what do you mean?? you ok?? 
Choose answer: 
 1) No no I am ok just little bit tired
 2) I don't know what is happening I am lost... i have some wierd dreams and something is wrong like sometimes i feel like I am falling...

* * *

>sleep
Player fell asleep
 The sound of the clock grows louder and more insistent. You feel its ticking resonating in your mind, as if urging you to act. It wakes you up.

 Player: WHATTTT??? 
 What is happening... Why is everything so noisy? 
 Player: I should go and check what is happening in living room (north)
You aren't feeling especially drowsy.

>destroy
Player starts to feel wierd and everything is green....

Player; Why is everything soo green what is this turquoise green colour...

 Player: Are walls green ???? What in the h....

 You hear footesteps someone is coming in room...

 Krsevan enters the room.

 Krsevan: What are you doing here? This is my room!

 Player: But... everything's green!

 Krsevan: It's my style, deal with it.

 Player: It's... too much green.

 Krsevan: Get used to it.

Player **thinks*~~I shouled probably ask Krsevan what time it is??~~
What do you want to destroy?

>ask krsevan about time
Player starts to feel wierd and everything is green....

Player; Why is everything soo green what is this turquoise green colour...

 Player: Are walls green ???? What in the h....

 You hear footesteps someone is coming in room...

 Krsevan enters the room.

 Krsevan: What are you doing here? This is my room!

 Player: But... everything's green!

 Krsevan: It's my style, deal with it.

 Player: It's... too much green.

 Krsevan: Get used to it.

Player **thinks*~~I shouled probably ask Krsevan what time it is??~~You can't see any such thing.

>look
Soba of Awakening
You find yourself again in a nearly empty room. The walls are gray and bare. Its ticking echoes in your mind, strangely familiar yet distant.

You can see a wooden table and an antique clock here.

>destory
That's not a verb I recognise.

* * *

>ask krsevan about time
Player starts to feel wierd and everything is green....

Player; Why is everything soo green what is this turquoise green colour...

 Player: Are walls green ???? What in the h....

 You hear footesteps someone is coming in room...

 Krsevan enters the room.

 Krsevan: What are you doing here? This is my room!

 Player: But... everything's green!

 Krsevan: It's my style, deal with it.

 Player: It's... too much green.

 Krsevan: Get used to it.

Player **thinks*~~I shouled probably ask Krsevan what time it is??~~You can't see any such thing.

>ask krsevan about time
You can't see any such thing.

>ask krsevan about town
You can't see any such thing.

>ask krsevan about time
You can't see any such thing.

>ask Krsevan abou time
You can't see any such thing.

>look
Soba of Awakening
You find yourself again in a nearly empty room. The walls are gray and bare. Its ticking echoes in your mind, strangely familiar yet distant.

You can see a wooden table and an antique clock here.

* * *

>look
Soba of Awakening
Everything is just green, room is green probably because this is Krsevan's room

You can see Krsevan, a hidden banana, a hidden paper, a wooden table and an antique clock here.

>look at banana
This banana has massage on it: "Sarmelo is crazy for bananas soo I will gift him one"

Player: ~~I feel dizzy... why is this green trying to attack me... damn green~~
You find yourself again in a nearly empty room. The walls are gray and bare. Its ticking echoes in your mind, strangely familiar yet distant.  
 you should probabaly go and see Laura

>look at paper
Oh this is Krsevan test... *looks closely* ... OMG his name is not Krsevan it is Luka

Player: ~~I feel dizzy... why is this green trying to attack me... damn green~~
You find yourself again in a nearly empty room. The walls are gray and bare. Its ticking echoes in your mind, strangely familiar yet distant.  
 you should probabaly go and see Laura

>go west
The Town Square
You step outside into the bustling town square. The air is filled with the sound of distant chatter and the smell of fresh bread from the bakery. In front of you, there are four people standing: three of them are strangers, and only one of them feels oddly familiar - Krševan.

You can see Sarmelo, Nona and Laura here.

Player: ~~I feel dizzy... why is this green trying to attack me... damn green~~
You find yourself again in a nearly empty room. The walls are gray and bare. Its ticking echoes in your mind, strangely familiar yet distant.  
 you should probabaly go and see Laura

Player: Laura is back from shopping I should probably ask her about banana

>ask laura about banana
Laura: OOO Yeaa! Here you go
Laura gave you banana! Not you can gift it to someone
Laura: Yea bye the way, do you know what is with Luka? He look angry.... and because of that he doesn't want to play Catan :(
 Choose answer: 
 3) Oooo he is moody but I will se what I can do
 4)No 

Player: ~~I feel dizzy... why is this green trying to attack me... damn green~~
You find yourself again in a nearly empty room. The walls are gray and bare. Its ticking echoes in your mind, strangely familiar yet distant.  
 you should probabaly go and see Laura

Player: Laura is back from shopping I should probably ask her about banana

>1
Laura: Oh ok good I don't have time for you right know, I just have this wierd craving and I don't know for what?? Have any idea??
That's not a verb I recognise.

>3
Laura: Oh ok good I don't have time for Luka right know, but I am ready to win in Catan
Player *thinks* ~Why is everyone now ready for Catan does it connect somehow with that one wierd dream....~
Player *thinks* ~I should appology to Krsevan... I mean Luka about his name~That's not a verb I recognise.

>Luka
Luka: Ohhh soo you are now done with that joke... ok...

Luka: Now that I am happy we can go and play Catan. I will show you how to win
 Player: Yea like you would win anyway
 Player *thinks* Ok so now I just need to ask Sarmelo if he wants to play Catan.
That's not a verb I recognise.

>ask sarmelo about catan
Sarmelo: No, I need something!!!

Player: ~~I feel dizzy... why is this green trying to attack me... damn green~~
You find yourself again in a nearly empty room. The walls are gray and bare. Its ticking echoes in your mind, strangely familiar yet distant.  
 you should probabaly go and see Laura

Player: Laura is back from shopping I should probably ask her about banana

>give banana to sarmelo
You can't see any such thing.

>what i have
That's not a verb I recognise.

>inventory
You are carrying nothing.

Player: ~~I feel dizzy... why is this green trying to attack me... damn green~~
You find yourself again in a nearly empty room. The walls are gray and bare. Its ticking echoes in your mind, strangely familiar yet distant.  
 you should probabaly go and see Laura

Player: Laura is back from shopping I should probably ask her about banana

* * *

>look at computer
The computer's screen flickers erratically, displaying strange symbols, but when you look closer, it's a Ryanair ticket??? You take a better look and try to find something on the computer that will help you understand, and you see the time on the computer is 5.6.2019!!!! Are we a few days in the past???? And you can see that ticket is sent on email to NONAAA?!?!?!?

>go west
The Town Square
You step outside into the bustling town square. The air is filled with the sound of distant chatter and the smell of fresh bread from the bakery. In front of you, there are four people standing: three of them are strangers, and only one of them feels oddly familiar - Krševan.

You can see Sarmelo, Nona, Laura and Krsevan here.

* * *

>ask nona about flight
Nona: WHAT HOW DO YOU KNOW ABOUT MY FLIGHT
*Thinkss* ~~Mybe I should ask her why is she stressed or mybe I should say her to chill down~~**thinks*

>power of thinking
Your insight is: Nona's flight tickets are on emailThat's not a verb I recognise.

>your tickets are on email
That's not a verb I recognise.

>your ticket is on email
Nona: WHAT DO YOU KNO... Wait they are on my email... Well *rolls her eyes* that is relief
Nona: Wait what are you doing here in Varazdin?

 Player: Well... mmmm.... I am here to visit someone?!

 Nona: Oooo who??

 Player: Aren't you curious?

Player **thinks*~~Ok so I know that I am in Varazdin and what now... Nona is way to curious and I don't know should I trust her, best thing is to ignore her from now on and she is probably ready for pension fund~~
 Player **thinks**~~I should go and sleep to clear my mind. What happened today, why was the clock so loud and where was I in that purple room, did I go crazy?~~That's not a verb I recognise.

* * *

>go north
Player: Why is Laura, Nona, Sarmelo and Krsevan here and what are they doing??? 
 It looks like they are playing some game... it that... catan and Krsevan is winning no wayyy 
 Player: I want to join and show you how to play catan. 
 After few minutes of playing I see Sarmelo with banana and laura favourit drink is pepsi and milk?? is that PILK??? disgusting, mybe she is craving PILK. 
 Wait what time is it where am I why is everyone so friendly right now with?? This is wierd I should ask what time it is

>ask sarmelo about time
You can't see any such thing.

>ask sarmelo about time
You can't see any such thing.

>ask nona about time
You can't see any such thing.

>ask laura about time
You can't see any such thing.

* * *

>go east
Soba of Awakening
You find yourself again in a nearly empty room. The walls are gray and bare. Its ticking echoes in your mind, strangely familiar yet distant.

You can see a wooden table and an antique clock here.

>smash
Player starts to feel wierd and everything is green....

Player; Why is everything soo green what is this turquoise green colour...

 Player: Are walls green ???? What in the h....

 You hear footesteps someone is coming in room...

 Krsevan enters the room.

 Krsevan: What are you doing here? This is my room!

 Player: But... everything's green!

 Krsevan: It's my style, deal with it.

 Player: It's... too much green.

 Krsevan: Get used to it.

Player **thinks*~~I shouled probably ask Krsevan what time it is??~~
What do you want to smash?

>ask krsevan abou time
Player starts to feel wierd and everything is green....

Player; Why is everything soo green what is this turquoise green colour...

 Player: Are walls green ???? What in the h....

 You hear footesteps someone is coming in room...

 Krsevan enters the room.

 Krsevan: What are you doing here? This is my room!

 Player: But... everything's green!

 Krsevan: It's my style, deal with it.

 Player: It's... too much green.

 Krsevan: Get used to it.

Player **thinks*~~I shouled probably ask Krsevan what time it is??~~You can't see any such thing.

* * *

>ask krsevan about town
Krsevan seems irritated. He doesn't want to talk right now. He looks like he's in no mood for conversation. He tells you to talk with Laura, Nona, and Sarmelo.

>ask laura about town
Laura seems lost in thought. She doesn't seem to want to talk right now. Perhaps she's too focused on her cravings.

>ask laura about town
Laura seems lost in thought. She doesn't seem to want to talk right now. Perhaps she's too focused on her cravings.

The sound of the clock grows louder and more insistent. You feel its ticking resonating in your mind, as if urging you to act. It is so loud that you need to go back to the room (east) and turn it off
The sound of the clock becomes deafening. You feel an overwhelming urge to return to the Soba of Awakening. (east)

>go east
The dizziness overwhelms you, and you need a moment to steady yourself.

Soba of Awakening
You stagger back into the room, your head spinning. You feel dizzy, and the air seems to buzz around you. The room has changed. It looks much tidier and cleaner now, as though someone has spent a long time organizing it. The once-bare walls are now spotless, and the table is neatly arranged with a small, mysterious object on it. The clock ticks more softly, almost as if it's calming you. You wonder if everything that just happened was real.

You can see Nona computer, a wooden table and an antique clock here.

* * *

>[enter]
What is happening room was purple with tiger print all around me.... and the clock was so lound but now it's quiet
I should ask Nona about this mybe she knows something

I beg your pardon?

>go east
You can't go that way.

* * *

I beg your pardon?

>chill down
Nona: LEAVE ME ALONEEE

I beg your pardon?

>power of thinking
Your insight is: Nona's flight tickets are on emailThat's not a verb I recognise.

I beg your pardon?

* * *

>[enter]
Player **thinks**~~I should go to sleep to clear my mind. What happened today? Why was the clock so loud, and where was I in that purple room? Did I go crazy?~~That's not a verb I recognise.

>go west
You can't go that way.

>go east
Soba of Awakening

 You find yourself again in a nearly empty room. The walls are gray and bare. Its ticking echoes in your mind, strangely familiar yet distant.

You can see a wooden table and an antique clock here.

* * *

>sleep
Player fell asleep
 The sound of the clock grows louder and more insistent. You feel its ticking resonating in your mind, as if urging you to act. It wakes you up.

Player: WHATTTT??? 
 What is happening... Why is everything so noisy? 
 Player: I should go and check what is happening in living room (north)
You aren't feeling especially drowsy.

>go north
Player: Why is Laura, Nona, Sarmelo and Krsevan here and what are they doing???

* * *

>[enter]
After a few minutes of playing, I see Sarmelo with a banana, and Laura's favorite drink is Pepsi and milk?? Is that PILK??? Disgusting, maybe she's craving PILK. 
 Wait, what time is it? Where am I? Why is everyone so friendly right now? This is weird. I should ask what time it is.

>ask nona about time
Nona: I don't know, am I late for something???.

* * *

>ask sarmelo about time
Sarmelo: Same as yesterday at this time.

>ask krsevan about time
Krsevan: You again with krsevan will you stop!!.

>ask laura about time
Laura: It's 21:20 1.7.2019.

* * *

>[enter]
You are awake now you should probably look at you wierd power of thinking and see if something will help you with Laura, Krsevan or Sarmelo and ask what is happening

>power of thinking
Your insight is: Laura loves PILK?!?! Ewww and is Sarmelo's favourite fruit banana?That's not a verb I recognise.

>go west
The Town Square
You step outside into the bustling town square. The air is filled with the sound of distant chatter and the smell of fresh bread from the bakery. In front of you, there are four people standing: three of them are strangers, and only one of them feels oddly familiar - Krševan.

You can see Krsevan, Sarmelo, Nona and Laura here.

* * *

>[enter]
Choose answer: 
 1) No no I am ok just little bit tired
 2) I don't know what is happening I am lost... I have some wierd dreams and something is wrong, sometimes I feel like I am falling... and that falling is always with me!!!

>1
Laura: Oh, okay, good. I don't have time for you right now. I just have this weird craving and I don't know for what. Any idea??
That's not a verb I recognise.

* * *

>[enter]
Player: It's... too much green.

 Krsevan: Get used to it.

>[enter]
Player **thinks*~~I shouled probably ask Krsevan what time it is??~~
What do you want to smash?

I beg your pardon?

>ask krsevan about time
Player starts to feel wierd and everything is green....

>[enter]
Player; Why is everything soo green what is this turquoise green colour...

* * *

>[enter]
Player: Are walls green ???? What in the h....

 You hear footesteps someone is coming in room...

Krsevan enters the room.

 Krsevan: What are you doing here? This is my room!

Player: But... everything's green!

Krsevan: It's my style, deal with it.

Player: It's... too much green.

 Krsevan: Get used to it.

Player **thinks*~~I shouled probably ask Krsevan what time it is??~~
Krsevan: You again with krsevan will you stop!!.

>ask krsevan about what is happening
Krsevan: WHY ARE YOU CALLING ME BY MY LAST NAME?!?!?! YOU OK!!

Krsevan runs out of room and slams the door

>7
*Thinks*~~Huh, what's up with him??? Anyway, let's explore the room. Maybe I will understand what is happening. (look)~~

>look
Soba of Awakening
Everything is just green. The room is green, probably because this is Krševan's room.

You can see Krsevan, a hidden banana, a hidden paper, a wooden table and an antique clock here.

>look at paper
Oh this is Krsevan test... *looks closely* ... OMG his name is not Krsevan it is Luka

* * *

>[enter]
You should probably go and see Laura

>go west
The Town Square
You step outside into the bustling town square. The air is filled with the sound of distant chatter and the smell of fresh bread from the bakery. In front of you, there are four people standing: three of them are strangers, and only one of them feels oddly familiar - Krševan.

You can see Sarmelo, Nona and Laura here.

Player: Laura is back from shopping. I should probably ask her about the banana.

>ask lauar about banana
You can't see any such thing.

>ask laura about banana
Laura: OOO Yeaa! Take it (Type take hidden banana)

>take hidden banana
Laura gave you banana! Now you can gift it to someone.

* * *

>[enter]
Choose answer: 
 3) Oooo, he is moody but I will see what I can do
 4) No 
Taken.

Player: ~~I feel dizzy... why is this green so overwhelming... damn, the green~~

>w
You find yourself again in a nearly empty room. The walls are gray and bare. Its ticking echoes in your mind, strangely familiar yet distant.

>[back]
You should probably go and see Laura

Player: Laura is back from shopping. I should probably ask her about the banana.

>3
Laura: Oh, okay, good. I don't have time for Luka right now, but I'm ready to win at Catan!

Player *thinks* ~Why is everyone ready for Catan now? Does it somehow connect with that one weird dream..~

* * *

>[enter]
Player *thinks* Ok so now I just need to ask Sarmelo if he wants to play Catan.That's not a verb I recognise.

>ask sarmelo about catan
Sarmelo: No, I need something!!!

Player: ~~I feel dizzy... why is this green so overwhelming... damn, the green~~

>[enter]
You find yourself again in a nearly empty room. The walls are gray and bare. Its ticking echoes in your mind, strangely familiar yet distant.

* * *

>[enter]
You should probably go and see Laura

Player: Laura is back from shopping. I should probably ask her about the banana.

>give banana to sarmelo
(first taking the hidden banana)

Sarmelo takes the banana and starts eating it with great satisfaction.

>[enter]
Sarmelo: "Ah, this is the best banana ever! Thank you, you've saved me."

Player: ~~I feel dizzy... why is this green so overwhelming... damn, the green~~

>[enter]
You find yourself again in a nearly empty room. The walls are gray and bare. Its ticking echoes in your mind, strangely familiar yet distant.

* * *

>[enter]
You should probably go and see Laura

Player: Laura is back from shopping. I should probably ask her about the banana.

>ask sarmelo about catan
Now everyone is happy and waiting for me to play catan.

 Player moves to living room where everyone is playing catan but everything feels similar
 Player thinks ~is this deja vu!?~
Living Room
A cozy living room with a sofa and a small coffee table. The air smells faintly of lavender.

 After playing for 30 min player is going to win... but when all of a sudden the player slipps from SARMEL'S BANANA PEEL AND STARTS TO FALL

>[enter]
Player hits his head hard on the floor....

>[enter]
You feel dizzy trie to move (type "reset" to regain your senses).

Sarmelo: No, I need something!!!

Player: ~~I feel dizzy... why is this green so overwhelming... damn, the green~~

>[enter]
You find yourself again in a nearly empty room. The walls are gray and bare. Its ticking echoes in your mind, strangely familiar yet distant.

* * *

>[enter]
You should probably go and see Laura

>restart
Now everyone is happy and waiting for me to play catan.

 Player moves to living room where everyone is playing catan but everything feels similar
 Player thinks ~is this deja vu!?~
Living Room
A cozy living room with a sofa and a small coffee table. The air smells faintly of lavender.

You can see Krsevan, Sarmelo, Nona and Laura here.

 After playing for 30 min player is going to win... but when all of a sudden the player slipps from SARMEL'S BANANA PEEL AND STARTS TO FALL

* * *

>[enter]
Player hits his head hard on the floor....

>[enter]
You feel dizzy trie to move (type "reset" to regain your senses).

Are you sure you want to restart?

Please answer yes or no.

Please answer yes or no.

* * *

>[enter]
You find yourself again in a nearly empty room. The walls are gray and bare. Its ticking echoes in your mind, strangely familiar yet distant.

>[right]
What is happening room was purple with tiger print all around me.... and the clock was so lound but now it's quiet
I should ask Nona about this mybe she knows something

>go west
The Town Square
You step outside into the bustling town square. The air is filled with the sound of distant chatter and the smell of fresh bread from the bakery. In front of you, there are four people standing: three of them are strangers, and only one of them feels oddly familiar - Krševan.

You can see Sarmelo, Nona, Laura and Krsevan here.

* * *

>ask nona about flight
Nona: WHAT HOW DO YOU KNOW ABOUT MY FLIGHT

>[right]
*Thinkss* ~~Mybe I should ask her why is she stressed or mybe I should say her to chill down~~**thinks*

>ask nona about stress
There is no reply.

>why are you stressed
Nona: I lost my ticket to Finland and I don't know what to do

* * *

>[right]
*Thinkss*That's not a verb I recognise.

>chill down
Nona: LEAVE ME ALONEEEThat's not a verb I recognise.

* * *

>look at computer
The computer's screen flickers erratically, displaying strange symbols, but when you look closer, it's a Ryanair ticket??? You take a better look and try to find something on the computer that will help you understand, and you see the time on the computer is 5.6.2019!!!! Are we a few days in the past???? And you can see that ticket is sent on email to NONAAA?!?!?!?

>[right]
*Thinks*
~~Hmmm, this room looks different. It has purple walls, and everything is purple. There are a lot of chocolates on the table and tiger prints?? Is this Nona's room? How is that possible? What is happening??~~
The sound of the clock grows louder and more insistent. You feel its ticking resonating in your mind, as if urging you to act. It is sooooo loud you need to go back to room (east) and turn it ofYou find yourself again in a nearly empty room. The walls are gray and bare. Its ticking echoes in your mind, strangely familiar yet distant.

What is happening room was purple with tiger print all around me.... and the clock was so lound but now it's quiet
I should ask Nona about this mybe she knows something

* * *

>look at computer
The computer's screen flickers erratically, displaying strange symbols, but when you look closer, it's a Ryanair ticket??? You take a better look and try to find something on the computer that will help you understand, and you see the time on the computer is 5.6.2019!!!! Are we a few days in the past???? And you can see that ticket is sent on email to NONAAA?!?!?!?

>g
*Thinks*

>[enter]
~~Hmmm, this room looks different. It has purple walls, and everything is purple. There are a lot of chocolates on the table and tiger prints?? Is this Nona's room? How is that possible? What is happening??~~

The sound of the clock grows louder and more insistent. You feel its ticking resonating in your mind, as if urging you to act. It is sooooo loud you need to go back to room (east) and turn it of

* * *

>[enter]
What is happening room was purple with tiger print all around me.... and the clock was so lound but now it's quiet
I should ask Nona about this mybe she knows something

>go east
You can't go that way.

>your ticket is on email
Nona: WHAT DO YOU KNO... Wait they are on my email... Well *rolls her eyes* that is a relief

* * *

>[enter]
Player **thinks**~~I should go to sleep to clear my mind. What happened today? Why was the clock so loud, and where was I in that purple room? Did I go crazy?~~That's not a verb I recognise.

>go east
You can't go that way.

* * *

>go west
The Town Square
You step outside into the bustling town square. The air is filled with the sound of distant chatter and the smell of fresh bread from the bakery. In front of you, there are four people standing: three of them are strangers, and only one of them feels oddly familiar - Krševan.

You can see Sarmelo, Nona, Laura and Krsevan here.

>go east
Soba of Awakening

 You find yourself again in a nearly empty room. The walls are gray and bare. Its ticking echoes in your mind, strangely familiar yet distant.

You can see a wooden table and an antique clock here.

* * *

>sleep
Player fell asleep
 The sound of the clock grows louder and more insistent. You feel its ticking resonating in your mind, as if urging you to act. It wakes you up.

>[enter]
Player: WHATTTT??? 
 What is happening... Why is everything so noisy? 
(new place unlocked: living room) 
 Player: I should go and check what is happening in living room (north)
You aren't feeling especially drowsy.

>go north
Player: Why is Laura, Nona, Sarmelo and Krsevan here and what are they doing???

>a
It looks like they are playing some game... is that... catan and Krsevan is winning... no wayyy

>a
Player: I want to join and show you how to play catan.

>a
After a few minutes of playing, I see Sarmelo with a banana, and Laura's favorite drink is Pepsi and milk?? Is that PILK??? Disgusting, maybe she's craving PILK. 
 Wait, what time is it? Where am I? Why is everyone so friendly right now? This is weird. I should ask what time it is.

>ask laura about time
Laura: It's 21:20 1.7.2019.

* * *

>go west
The Town Square
You step outside into the bustling town square. The air is filled with the sound of distant chatter and the smell of fresh bread from the bakery. In front of you, there are four people standing: three of them are strangers, and only one of them feels oddly familiar - Krševan.

You can see Krsevan, Sarmelo, Nona and Laura here.

>ask laura about what is happenng
There is no reply.

>ask laura about what is happening
Laura: I don't know.. what do you mean?? you ok??

* * *

>[enter]
Player **thinks*~~I shouled probably ask Krsevan what is happening??~~
What do you want to smash?

>ask krsevan about what is happening
Krsevan: WHY ARE YOU CALLING ME BY MY LAST NAME?!?!?! YOU OK!!

Krsevan runs out of room and slams the door

* * *

>look at paper
Oh this is Krsevan test... *looks closely* ... OMG his name is not Krsevan it is Luka

>look at banana
This banana has massage on it: "Sarmelo is crazy for bananas soo I will gift him one"

Player: ~~I feel dizzy... why is this green so overwhelming... damn, the green~~

* * *

>[enter]
You should probably go and see Laura

>look
Soba of Awakening
You find yourself again in a nearly empty room. The walls are gray and bare. Its ticking echoes in your mind, strangely familiar yet distant.

You can see Krsevan, a wooden table and an antique clock here.

>go east
You can't go that way.

>go west
The Town Square
You step outside into the bustling town square. The air is filled with the sound of distant chatter and the smell of fresh bread from the bakery. In front of you, there are four people standing: three of them are strangers, and only one of them feels oddly familiar - Krševan.

You can see Sarmelo, Nona and Laura here.

Player: Laura is back from shopping. I should probably ask her about the banana.

* * *

>[enter]
Player *thinks* Ok so now I just need to ask Sarmelo if he wants to play Catan.That's not a verb I recognise.

>ask sarmelo about banana
There is no reply.

Player: ~~I feel dizzy... why is this green so overwhelming... damn, the green~~

* * *

>[enter]
You feel dizzy trie to move (type "restart" to regain your senses).

You can't go that way.

>restart
Are you sure you want to restart?

Please answer yes or no.

* * *

>go west
You can't go that way.

>go east
Soba of Awakening
You find yourself again in a nearly empty room. The walls are gray and bare. Its ticking echoes in your mind, strangely familiar yet distant.

You can see a wooden table and an antique clock here.

* * *

>smash
Player starts to feel wierd and everything is green....

Player; Why is everything soo green what is this turquoise green colour...

 Player: Are walls green ???? What in the h....

 You hear footesteps someone is coming in room...

 Krsevan enters the room.

 Krsevan: What are you doing here? This is my room!

 Player: But... everything's green!

 Krsevan: It's my style, deal with it.

 Player: It's... too much green.

 Krsevan: Get used to it.

Player **thinks*~~I shouled probably ask Krsevan what time it is??~~
What do you want to smash?

>look
Player starts to feel wierd and everything is green....

Player; Why is everything soo green what is this turquoise green colour...

 Player: Are walls green ???? What in the h....

 You hear footesteps someone is coming in room...

 Krsevan enters the room.

 Krsevan: What are you doing here? This is my room!

 Player: But... everything's green!

 Krsevan: It's my style, deal with it.

 Player: It's... too much green.

 Krsevan: Get used to it.

Player **thinks*~~I shouled probably ask Krsevan what time it is??~~
Soba of Awakening
You find yourself again in a nearly empty room. The walls are gray and bare. Its ticking echoes in your mind, strangely familiar yet distant.

You can see Krsevan, a hidden banana, a hidden paper, a wooden table and an antique clock here.

>ask krsevan about time
Krsevan: You again with krsevan will you stop!!.

>look at banana
Ova banana ima poruku urezanu na sebi: "Sarmelo je lud za bananama!"

>look at paper
Na papiru piše: "Krsevan se zapravo zove Luka."

* * *

>go west
The Town Square
You step outside into the bustling town square. The air is filled with the sound of distant chatter and the smell of fresh bread from the bakery. In front of you, there are four people standing: three of them are strangers, and only one of them feels oddly familiar - Krševan.

You can see Sarmelo, Nona, Laura and Krsevan here.

>ask nona
What do you want to ask Nona for?

>ask nona about town
You approach Nona, and she looks visibly stressed. She starts speaking quickly, almost frantically.
"Oh, I have to go to Finland, but I can't find the ticket! Something is wrong, I don't know what's happening! Can you help me?"

1) Error: no link text for Nona-stress. 
2) Error: no link text for Nona-ticket. 
(or 0 to say nothing)
>

* * *

>ask nona about flight
Nona: WHAT HOW DO YOU KNOW ABOUT MY FLIGHT
*Thinkss* ~~Mybe I should ask her why is she stressed or mybe I should say her to chill down~~**thinks*

I beg your pardon?

>why are you stressed
Nona: I lost my ticket to Finland and I don't know what to do*Thinkss*That's not a verb I recognise.

* * *

>ask laura about time
Laura seems lost in thought. She doesn't seem to want to talk right now. Perhaps she's too focused on her cravings.

>ask sarmelo about time
Sarmelo seems too preoccupied to talk. He keeps muttering about needing to find some fruit.

>ask krsevan about time
Krsevan seems irritated. He doesn't want to talk right now. He looks like he's in no mood for conversation. He tells you to talk with Laura, Nona, and Sarmelo.

>ask nona about time
You can't see any such thing.

* * *

>ask laura about time
You can't see any such thing.

>ask laura about time
You can't see any such thing.

>location
That's not a verb I recognise.

>where am i
That's not a verb I recognise.

>go north
You can't go that way.

>go south
Soba of Awakening
You find yourself again in a nearly empty room. The walls are gray and bare. Its ticking echoes in your mind, strangely familiar yet distant.

You can see a wooden table and an antique clock here.

>go north
Player: Why is Laura, Nona, Sarmelo and Krsevan here and what are they doing??? 
 It looks like they are playing some game... it that... catan and Krsevan is winning no wayyy 
 Player: I want to join and show you how to play catan. 
 After few minutes of playing I see Sarmelo with banana and laura favourit drink is pepsi and milk?? is that PILK??? disgusting, mybe she is craving PILK. 
 Wait what time is it where am I why is everyone so friendly right now with?? This is wierd I should ask what time it is

* * *

>ask laura about time
Laura seems lost in thought. She doesn't seem to want to talk right now. Perhaps she's too focused on her cravings.

>1
Laura: Oh ok good I don't have time for you right know, I just have this wierd craving and I don't know for what?? Have any idea??
That's not a verb I recognise.

>2
Laura: OKKKKEEYYY you wierdo, go home and take your problems with yourself I am not psychologist pfffffThat's not a verb I recognise.

>PILK
Laura: OMG yes that's what I need that you soo much now I can buy what I need do you want something like fruit or something...??

 Player: *Thinks**~~Hmmmm fruit mybe Sarmelo would like to have fruit.... BANANA ~~ 
 Yes buy me banana
 Laura; Ok see you tomorrow
 

 Player: I should think about everything...

 After trying to piece everything together player head starts to heart and he can hear something???
The sound of the clock grows louder and more insistent. You feel its ticking resonating in your mind, as if urging you to act. You need to run and see that clockThat's not a verb I recognise.

>go south
Soba of Awakening
You find yourself again in a nearly empty room. The walls are gray and bare. Its ticking echoes in your mind, strangely familiar yet distant.

You can see a wooden table and an antique clock here.

>destroy
Player starts to feel wierd and everything is green....

Player; Why is everything soo green what is this turquoise green colour...

 Player: Are walls green ???? What in the h....

 You hear footesteps someone is coming in room...

 Krsevan enters the room.

 Krsevan: What are you doing here? This is my room!

 Player: But... everything's green!

 Krsevan: It's my style, deal with it.

 Player: It's... too much green.

 Krsevan: Get used to it.

Player **thinks*~~I shouled probably ask Krsevan what time it is??~~
What do you want to destroy?

* * *

>ask nona about flight
Nona: WHAT HOW DO YOU KNOW ABOUT MY FLIGHT
*Thinkss* ~~Mybe I should ask her why is she stressed or mybe I should say her to chill down~~**thinks*

>Nona Chill down
That's not a verb I recognise.

>chill down
That's not a verb I recognise.

>Ask nona chill down
I didn't understand that sentence.

>Why are you stressed
That's not a verb I recognise.

>Nona why are you stressed
That's not a verb I recognise.

>Why are you stressed
That's not a verb I recognise.

>Nona Why are you stressed
That's not a verb I recognise.

>Ask Nona about Why are you stressed
Nona: I lost my ticket to Finland and I don't know what to do*Thinkss*

>aks nona about flight
That's not a verb I recognise.

>aks nona about chill down
That's not a verb I recognise.

>ask nona about chill down
Nona: LEAVE ME ALONEEE

>power of thinking
Your insight is: Nona's flight tickets are on emailThat's not a verb I recognise.

>Ask nona about your ticket are on email
Nona tell me what is happening??.

 WHAT DODN'T YOU SEE I HAVE BETTER THINGS TO DO

>ask nona about your ticket are on email
Nona tell me what is happening??.

 WHAT DODN'T YOU SEE I HAVE BETTER THINGS TO DO

* * *

>1
Laura: Oh ok good I don't have time for you right know, I just have this wierd craving and I don't know for what?? Have any idea??
That's not a verb I recognise.

>1
Laura: Oh ok good I don't have time for you right know, I just have this wierd craving and I don't know for what?? Have any idea??
That's not a verb I recognise.

* * *

>look
Soba of Awakening
Everything is just green, room is green probably because this is Krsevan's room

You can see Krsevan, a hidden banana, a hidden paper, a wooden table and an antique clock here.

>look at hidden paper
Oh this is Krsevan test... *looks closely* ... OMG his name is not Krsevan it is Luka

>look at banana
This banana has massage on it: "Sarmelo is crazy for bananas soo I will gift him one"

Player: ~~I feel dizzy... why is this green trying to attack me... damn green~~
You find yourself again in a nearly empty room. The walls are gray and bare. Its ticking echoes in your mind, strangely familiar yet distant.  
 you should probabaly go and see Laura

>go west
The Town Square
You step outside into the bustling town square. The air is filled with the sound of distant chatter and the smell of fresh bread from the bakery. In front of you, there are four people standing: three of them are strangers, and only one of them feels oddly familiar - Krševan.

You can see Sarmelo, Nona and Laura here.

Player: Laura is back from shopping I should probably ask her about banana

>ask laura about banana
Laura: OOO Yeaa! Take it (Type take hidden banana)

Player: ~~I feel dizzy... why is this green trying to attack me... damn green~~
You find yourself again in a nearly empty room. The walls are gray and bare. Its ticking echoes in your mind, strangely familiar yet distant.  
 you should probabaly go and see Laura

Player: Laura is back from shopping I should probably ask her about banana

>take hidden banana
Laura gave you banana! Now you can gift it to someone.

Laura: By the way, do you know what's with Luka? He looks angry... and because of that, he doesn't want to play Catan :(
 Choose answer: 
 3) Oooo, he is moody but I will see what I can do
 4) No 
Taken.

Player: ~~I feel dizzy... why is this green trying to attack me... damn green~~
You find yourself again in a nearly empty room. The walls are gray and bare. Its ticking echoes in your mind, strangely familiar yet distant.  
 you should probabaly go and see Laura

Player: Laura is back from shopping I should probably ask her about banana

>1
Laura: Oh ok good I don't have time for you right know, I just have this wierd craving and I don't know for what?? Have any idea??
That's not a verb I recognise.

* * *

>3
Laura: Oh ok good I don't have time for Luka right know, but I am ready to win in Catan
Player *thinks* ~Why is everyone now ready for Catan does it connect somehow with that one wierd dream....~
Player *thinks* ~I should appology to Krsevan... I mean Luka about his name~That's not a verb I recognise.

>inventory
You are carrying nothing.

>take hidden banana
Taken.

Player: ~~I feel dizzy... why is this green trying to attack me... damn green~~
You find yourself again in a nearly empty room. The walls are gray and bare. Its ticking echoes in your mind, strangely familiar yet distant.  
 you should probabaly go and see Laura

Player: Laura is back from shopping I should probably ask her about banana

>inventory
You are carrying nothing.

>take banana
Taken.

Player: ~~I feel dizzy... why is this green trying to attack me... damn green~~
You find yourself again in a nearly empty room. The walls are gray and bare. Its ticking echoes in your mind, strangely familiar yet distant.  
 you should probabaly go and see Laura

Player: Laura is back from shopping I should probably ask her about banana

>inventory
You are carrying nothing.

>ask sarmelo about catan
Sarmelo: No, I need something!!!

>give sarmelo banana
(first taking the hidden banana)

Sarmelo takes the banana and starts eating it with great satisfaction.

Sarmelo: "Ah, this is the best banana ever! Thank you, you've saved me."

Player: ~~I feel dizzy... why is this green trying to attack me... damn green~~
You find yourself again in a nearly empty room. The walls are gray and bare. Its ticking echoes in your mind, strangely familiar yet distant.  
 you should probabaly go and see Laura

Player: Laura is back from shopping I should probably ask her about banana

>give sarmelo banana
(first taking the hidden banana)

Sarmelo takes the banana and starts eating it with great satisfaction.

Sarmelo: "Ah, this is the best banana ever! Thank you, you've saved me."

Player: ~~I feel dizzy... why is this green trying to attack me... damn green~~
You find yourself again in a nearly empty room. The walls are gray and bare. Its ticking echoes in your mind, strangely familiar yet distant.  
 you should probabaly go and see Laura

Player: Laura is back from shopping I should probably ask her about banana

>luka
Luka: Ohhh soo you are now done with that joke... ok...

Luka: Now that I am happy we can go and play Catan. I will show you how to win
 Player: Yea like you would win anyway
 Player *thinks* Ok so now I just need to ask Sarmelo if he wants to play Catan.
That's not a verb I recognise.

* * *

>ask laura about time
Laura: It's 21:20 1.7.2019.

 Player: What I am in FUTURE??? this is some wierd dream... oh at least I'll show them how to play catan.

 After playing and almost wining you stand up and feel a strange sensation of falling after which you wake up
 You are awake now you should probably look at you wierd power of thinking and see if something will help you with Laura, Krsevan or Sarmelo and ask what is happening

>power of thinking
Your insight is: Laura loves PILK?!?! Ewww and is Sarmelo favourite fruit banana?That's not a verb I recognise.

>go south
Soba of Awakening
You find yourself again in a nearly empty room. The walls are gray and bare. Its ticking echoes in your mind, strangely familiar yet distant.

You can see a wooden table and an antique clock here.

* * *

>go east
Soba of Awakening
You find yourself again in a nearly empty room. The walls are gray and bare. Its ticking echoes in your mind, strangely familiar yet distant.

You can see a wooden table and an antique clock here.

Player: What is happening with this clock? I NEED TO SMASH IT, I CANNOT WITH THIS SOUND!

Weird noises: smash.... smash.... smash........

* * *

>smash
Player starts to feel wierd and everything is green....

Player; Why is everything soo green what is this turquoise green colour...

 Player: Are walls green ???? What in the h....

 You hear footesteps someone is coming in room...

 Krsevan enters the room.

 Krsevan: What are you doing here? This is my room!

 Player: But... everything's green!

 Krsevan: It's my style, deal with it.

 Player: It's... too much green.

 Krsevan: Get used to it.

Player **thinks*~~I shouled probably ask Krsevan what time it is??~~
What do you want to smash?

>ask krsevan about time
Player starts to feel wierd and everything is green....

Player; Why is everything soo green what is this turquoise green colour...

 Player: Are walls green ???? What in the h....

 You hear footesteps someone is coming in room...

 Krsevan enters the room.

 Krsevan: What are you doing here? This is my room!

 Player: But... everything's green!

 Krsevan: It's my style, deal with it.

 Player: It's... too much green.

 Krsevan: Get used to it.

Player **thinks*~~I shouled probably ask Krsevan what time it is??~~
Krsevan: You again with krsevan will you stop!!.

>ask krsevan about time
Krsevan: You again with krsevan will you stop!!.

* * *

>look at table
On the table, you see a small, mysterious computer. Its screen flickers with strange symbols, and you wonder what purpose it serves. Something about it feels out of place, but it might hold the key to understanding what's happening here.

>look at computer
The computer's screen flickers erratically, displaying strange symbols, but when you look closer, it's a Ryanair ticket??? You take a better look and try to find something on the computer that will help you understand, and you see the time on the computer is 5.6.2019!!!! Are we a few days in the past???? And you can see that ticket is sent on email to NONAAA?!?!?!?

* * *

>go west
The Town Square
You step outside into the bustling town square. The air is filled with the sound of distant chatter and the smell of fresh bread from the bakery. In front of you, there are four people standing: three of them are strangers, and only one of them feels oddly familiar - Krševan.

You can see Sarmelo, Nona, Laura and Krsevan here.

>go east
Soba of Awakening
You find yourself again in a nearly empty room. The walls are gray and bare. Its ticking echoes in your mind, strangely familiar yet distant.

You can see Nona computer, a wooden table and an antique clock here.

* * *

>ask laura about town
Laura seems lost in thought. She doesn't seem to want to talk right now. Perhaps she's too focused on her cravings.

>ask nona about town
Nona doesn't seem interested in talking right now, she's too focused on finding her lost tickets.

>ask sarmelo about town
Sarmelo seems too preoccupied to talk. He keeps muttering about needing to find some fruit.

The sound of the clock grows louder and more insistent. You feel its ticking resonating in your mind, as if urging you to act. It is sooooo loud you need to go back to room (east) and turn it of
The sound of the clock becomes deafening. You feel an overwhelming urge to return to the Soba of Awakening. (east)

>go east
The dizziness overwhelms you, and you need a moment to steady yourself.

Soba of Awakening
You stagger back into the room, your head spinning. You feel dizzy, and the air seems to buzz around you. The room has changed. It looks much tidier and cleaner now, as though someone has spent a long time organizing it. The once-bare walls are now spotless, and the table is neatly arranged with a small, mysterious object on it. The clock ticks more softly, almost as if it's calming you. You wonder if everything that just happened was real.

You can see Nona computer, a wooden table and an antique clock here.

* * *

>look at computer
The computer's screen flickers erratically, displaying strange symbols, but when you look closer, it's a Ryanair ticket??? You take a better look and try to find something on the computer that will help you understand, and you see the time on the computer is 5.6.2019!!!! Are we a few days in the past???? And you can see that ticket is sent on email to NONAAA?!?!?!?

>[right]
*Thinks*

>[right]
~~Hmmm, this room looks different. It has purple walls, and everything is purple. There are a lot of chocolates on the table and tiger prints?? Is this Nona's room? How is that possible? What is happening??~~
The sound of the clock grows louder and more insistent. You feel its ticking resonating in your mind, as if urging you to act. It is sooooo loud you need to go back to room (east) and turn it of

* * *

>[right]
You find yourself again in a nearly empty room. The walls are gray and bare. Its ticking echoes in your mind, strangely familiar yet distant.

>[right]
What is happening room was purple with tiger print all around me.... and the clock was so lound but now it's quiet
I should ask Nona about this mybe she knows something

* * *

>go west
The Town Square
You step outside into the bustling town square. The air is filled with the sound of distant chatter and the smell of fresh bread from the bakery. In front of you, there are four people standing: three of them are strangers, and only one of them feels oddly familiar - Krševan.

You can see Sarmelo, Nona, Laura and Krsevan here.

>chill down
Nona: LEAVE ME ALONEEE

* * *

>ask krsevan about town
Krsevan seems irritated. He doesn't want to talk right now. He looks like he's in no mood for conversation. He tells you to talk with Laura, Nona, and Sarmelo.

>ask nona about s
Nona doesn't seem interested in talking right now, she's too focused on finding her lost tickets.

>ask nona about s
Nona doesn't seem interested in talking right now, she's too focused on finding her lost tickets.

>ask nona about s
Nona doesn't seem interested in talking right now, she's too focused on finding her lost tickets.

The sound of the clock grows louder and more insistent. You feel its ticking resonating in your mind, as if urging you to act. It is sooooo loud you need to go back to room (east) and turn it of
The sound of the clock becomes deafening. You feel an overwhelming urge to return to the Soba of Awakening. (east)

>go east
The dizziness overwhelms you, and you need a moment to steady yourself.

Soba of Awakening
You stagger back into the room, your head spinning. You feel dizzy, and the air seems to buzz around you. The room has changed. It looks much tidier and cleaner now, as though someone has spent a long time organizing it. The once-bare walls are now spotless, and the table is neatly arranged with a small, mysterious object on it. The clock ticks more softly, almost as if it's calming you. You wonder if everything that just happened was real.

You can see Nona computer, a wooden table and an antique clock here.

* * *

>ask nona about flight
Nona: WHAT HOW DO YOU KNOW ABOUT MY FLIGHT
*Thinkss* ~~Mybe I should ask her why is she stressed or mybe I should say her to chill down~~**thinks*

>why are you stressed
Nona: I lost my ticket to Finland and I don't know what to do*Thinkss*That's not a verb I recognise.

>chill down
Nona: LEAVE ME ALONEEEThat's not a verb I recognise.

>you gave ticket on email
That's not a verb I recognise.

>you have ticket on email
That's not a verb I recognise.

>your ticket is on email
Nona: WHAT DO YOU KNO... Wait they are on my email... Well *rolls her eyes* that is relief
Nona: Wait what are you doing here in Varazdin?

 Player: Well... mmmm.... I am here to visit someone?!

 Nona: Oooo who??

 Player: Aren't you curious?

Player **thinks*~~Ok so I know that I am in Varazdin and what now... Nona is way to curious and I don't know should I trust her, best thing is to ignore her from now on and she is probably ready for pension fund~~
 Player **thinks**~~I should go and sleep to clear my mind. What happened today, why was the clock so loud and where was I in that purple room, did I go crazy?~~That's not a verb I recognise.

>go east
Soba of Awakening
You find yourself again in a nearly empty room. The walls are gray and bare. Its ticking echoes in your mind, strangely familiar yet distant.

You can see a wooden table and an antique clock here.

*You don't want to speek with Nona*
Nona is no longer willing to talk to you

>sleep
Player fell asleep
 
You aren't feeling especially drowsy.

The sound of the clock grows louder and more insistent. You feel its ticking resonating in your mind, as if urging you to act. It is sooooo loud you need to go back to room (east) and turn it of
*You don't want to speek with Nona*
The sound of the clock becomes deafening. You feel an overwhelming urge to return to the Soba of Awakening. (east)
Nona is no longer willing to talk to you

* * *

>ask Nona about flight
Nona: WHAT HOW DO YOU KNOW ABOUT MY FLIGHT
*Thinkss* ~~Mybe I should ask her why is she stressed or mybe I should say her to chill down~~**thinks*

>why are you stressed
Nona: I lost my ticket to Finland and I don't know what to do*Thinkss*That's not a verb I recognise.

* * *

>chill down
Nona: LEAVE ME ALONEEEThat's not a verb I recognise.

>ask Nona about flight
Nona: WHAT HOW DO YOU KNOW ABOUT MY FLIGHT
*Thinkss* ~~Mybe I should ask her why is she stressed or mybe I should say her to chill down~~**thinks*

>your ticket is on email
Nona: WHAT DO YOU KNO... Wait they are on my email... Well *rolls her eyes* that is relief
Nona: Wait what are you doing here in Varazdin?

 Player: Well... mmmm.... I am here to visit someone?!

 Nona: Oooo who??

 Player: Aren't you curious?

Player **thinks*~~Ok so I know that I am in Varazdin and what now Nona is way to curious and I don't know should i trust her, best thing is to ignore her from now on and she is probably ready for pension fund~~That's not a verb I recognise.

>ask nona about c
Nona tell me what is happening??.

 WHAT DODN'T YOU SEE I HAVE BETTER THINGS TO DO
*You don't want to speek with Nona*
Nona is no longer willing to talk to you

* * *

>ask krsevan about town
Krsevan seems irritated. He doesn't want to talk right now. He looks like he's in no mood for conversation. He tells you to talk with Laura, Nona, and Sarmelo.

>ask nona about t
Nona doesn't seem interested in talking right now, she's too focused on finding her lost tickets.

* * *

>look at computer
The computer's screen flickers erratically, displaying strange symbols, but when you look closer, it's a Ryanair ticket??? You take a better look and try to find something on the computer that will help you understand, and you see the time on the computer is 5.6.2019!!!! Are we a few days in the past???? And you can see that ticket is sent on email to NONAAA?!?!?!?
*Thinks*~~Hmmm, this room looks different. It has purple walls, and everything is purple. There are a lot of chocolates on the table and tiger prints?? Is this Nona's room? How is that possible? What is happening??~~
The sound of the clock grows louder and more insistent. You feel its ticking resonating in your mind, as if urging you to act. It is sooooo loud you need to go back to room (east) and turn it ofYou find yourself again in a nearly empty room. The walls are gray and bare. Its ticking echoes in your mind, strangely familiar yet distant.
What is happening room was purple with tiger print all around me.... and the clock was so lound but now it's quietI should ask Nona about this mybe she knows something
Nona is no longer willing to talk to you

>go west
The Town Square
You step outside into the bustling town square. The air is filled with the sound of distant chatter and the smell of fresh bread from the bakery. In front of you, there are four people standing: three of them are strangers, and only one of them feels oddly familiar - Krševan.

You can see Sarmelo, Nona, Laura and Krsevan here.

Nona is no longer willing to talk to you

>ask nona about flight
Nona: WHAT HOW DO YOU KNOW ABOUT MY FLIGHT
*Thinkss* ~~Mybe I should ask her why is she stressed or mybe I should say her to chill down~~**thinks*

* * *

>chill down
Nona: LEAVE ME ALONEEEThat's not a verb I recognise.

>power of thinking
Your insight is: Nona's flight tickets are on emailThat's not a verb I recognise.

>why are you stressed
Nona: I lost my ticket to Finland and I don't know what to do*Thinkss*That's not a verb I recognise.

><your ticket are on email
That's not a verb I recognise.

>your ticket are on email
Nona: WHAT DO YOU KNO... Wait they are on my email... Well *rolls her eyes* that is relief
Nona: Wait what are you doing here in Varazdin?

 Player: Well... mmmm.... I am here to visit someone?!

 Nona: Oooo who??

 Player: Aren't you curious?

Player **thinks*~~Ok so I know that I am in Varazdin and what now Nona is way to curious and I don't know should i trust her, best thing is to ignore her from now on and she is probably ready for pension fund~~That's not a verb I recognise.

>ask nona about city
Nona tell me what is happening??.

 WHAT DODN'T YOU SEE I HAVE BETTER THINGS TO DO
*You don't want to speek with Nona*
Nona is no longer willing to talk to you

* * *

>ask krsevan about town
Krsevan seems irritated. He doesn't want to talk right now. He looks like he's in no mood for conversation. He tells you to talk with Laura, Nona, and Sarmelo.

>ask nona about town
Nona doesn't seem interested in talking right now, she's too focused on finding her lost tickets.

>ask laura about town
Laura seems lost in thought. She doesn't seem to want to talk right now. Perhaps she's too focused on her cravings.

>ask sarmelo about town
Sarmelo seems too preoccupied to talk. He keeps muttering about needing to find some fruit.

The sound of the clock grows louder and more insistent. You feel its ticking resonating in your mind, as if urging you to act. It is sooooo loud you need to go back to room (east) and turn it of
The sound of the clock becomes deafening. You feel an overwhelming urge to return to the Soba of Awakening. (east)

* * *

I beg your pardon?

>look at computer
The computer's screen flickers erratically, displaying strange symbols, but when you look closer, it's a Ryanair ticket??? You take a better look and try to find something on the computer that will help you understand, and you see the time on the computer is 5.6.2019!!!! Are we a few days in the past???? And you can see that ticket is sent on email to NONAAA?!?!?!?

* * *

>[enter]
*Thinks*

>[enter]
~~Hmmm, this room looks different. It has purple walls, and everything is purple. There are a lot of chocolates on the table and tiger prints?? Is this Nona's room? How is that possible? What is happening??~~
The sound of the clock grows louder and more insistent. You feel its ticking resonating in your mind, as if urging you to act. It is sooooo loud you need to go back to room (east) and turn it of

* * *

>go west
The Town Square
You step outside into the bustling town square. The air is filled with the sound of distant chatter and the smell of fresh bread from the bakery. In front of you, there are four people standing: three of them are strangers, and only one of them feels oddly familiar - Krševan.

You can see Sarmelo, Nona, Laura and Krsevan here.

>your ticket is on email
Nona: WHAT DO YOU KNO... Wait they are on my email... Well *rolls her eyes* that is relief

>[enter]
Nona: Wait what are you doing here in Varazdin?

* * *

>[enter]
Player: Aren't you curious?

>[enter]
Player **thinks*~~Ok so I know that I am in Varazdin and what now... Nona is way to curious and I don't know should I trust her, best thing is to ignore her from now on and she is probably ready for pension fund~~

>[enter]
Player **thinks**~~I should go and sleep to clear my mind. What happened today, why was the clock so loud and where was I in that purple room, did I go crazy?~~That's not a verb I recognise.

>go east
Soba of Awakening

 You find yourself again in a nearly empty room. The walls are gray and bare. Its ticking echoes in your mind, strangely familiar yet distant.

You can see a wooden table and an antique clock here.

* * *

>sleep
Player fell asleep
 The sound of the clock grows louder and more insistent. You feel its ticking resonating in your mind, as if urging you to act. It wakes you up.

>[enter]
Player: WHATTTT??? 
 What is happening... Why is everything so noisy? 
 Player: I should go and check what is happening in living room (north)
You aren't feeling especially drowsy.

>go north
Player: Why is Laura, Nona, Sarmelo and Krsevan here and what are they doing???

>[enter]
It looks like they are playing some game... it that... catan and Krsevan is winning no wayyy

>[enter]
Player: I want to join and show you how to play catan.

>[enter]
After few minutes of playing I see Sarmelo with banana and laura favourit drink is pepsi and milk?? is that PILK??? disgusting, mybe she is craving PILK. 
 Wait what time is it where am I why is everyone so friendly right now with?? This is wierd I should ask what time it is

>ask nona about time
Nona: I don't know, am I late for something???.

>ask sarmelo about town
There is no reply.

>ask sarmelo about time
Sarmelo: Same as yesterday at this time.

* * *

>ask laura about time
Laura: It's 21:20 1.7.2019.

>[enter]
Player: What I am in FUTURE??? this is some wierd dream... oh at least I'll show them how to play catan.

>[enter]
After playing and almost wining you stand up and feel a strange sensation of falling after which you wake up

>[enter]
You are awake now you should probably look at you wierd power of thinking and see if something will help you with Laura, Krsevan or Sarmelo and ask what is happening

>power of thinking
Your insight is: Laura loves PILK?!?! Ewww and is Sarmelo favourite fruit banana?That's not a verb I recognise.

>go south
Soba of Awakening

 You find yourself again in a nearly empty room. The walls are gray and bare. Its ticking echoes in your mind, strangely familiar yet distant.

You can see a wooden table and an antique clock here.

>go west
The Town Square
You step outside into the bustling town square. The air is filled with the sound of distant chatter and the smell of fresh bread from the bakery. In front of you, there are four people standing: three of them are strangers, and only one of them feels oddly familiar - Krševan.

You can see Krsevan, Sarmelo, Nona and Laura here.

* * *

>ask laura about what is happening
Laura: I don't know.. what do you mean?? you ok??

>[enter]
Choose answer: 
 1) No no I am ok just little bit tired
 2) I don't know what is happening I am lost... i have some wierd dreams and something is wrong like sometimes i feel like I am falling...

>1
Laura: Oh ok good I don't have time for you right know, I just have this wierd craving and I don't know for what?? Have any idea??
That's not a verb I recognise.

>ask sarmelo what is happening
I didn't understand that sentence.

>ask krsevan about what is happening
Krsevan: WHY ARE YOU CALLING ME BY MY LAST NAME?!?!?! YOU OK!!

Krsevan runs out of room and slams the door

>[enter]
*Thinks*~~Huh what's up with him??? anyway let's explore room mybe I will understand what is happening (look)~~

I beg your pardon?

>ask sarmelo about what is happening
There is no reply.

>ask laura about what is happening
Laura: I don't know.. what do you mean?? you ok??

* * *

>[enter]
Choose answer: 
 1) No no I am ok just little bit tired
 2) I don't know what is happening I am lost... i have some wierd dreams and something is wrong like sometimes i feel like I am falling...

>2
Laura: OKKKKEEYYY you wierdo, go home and take your problems with yourself I am not psychologist pfffffThat's not a verb I recognise.

>ask laura about what is happening
Laura: I don't know.. what do you mean?? you ok??

* * *

>1
Laura: Oh ok good I don't have time for you right know, I just have this wierd craving and I don't know for what?? Have any idea??
That's not a verb I recognise.

>pilk
Laura: OMG yes that's what I need that you soo much now I can buy what I need do you want something like fruit or something...??

>[enter]
Player: *Thinks**~~Hmmmm fruit mybe Sarmelo would like to have fruit.... BANANA ~~ 
 Yes buy me banana

>[enter]
Laura; Ok see you tomorrow

* * *

>[enter]
Player **thinks*~~I shouled probably ask Krsevan what time it is??~~
What do you want to smash?

>ask krsevan about time
Player starts to feel wierd and everything is green....

* * *

>[enter]
Player: It's... too much green.

 Krsevan: Get used to it.

>[enter]
Player **thinks*~~I shouled probably ask Krsevan what time it is??~~
Krsevan: You again with krsevan will you stop!!.

>ask krsevan about what is happening
Krsevan: WHY ARE YOU CALLING ME BY MY LAST NAME?!?!?! YOU OK!!

Krsevan runs out of room and slams the door

* * *

>[enter]
*Thinks*~~Huh what's up with him??? anyway let's explore room mybe I will understand what is happening (look)~~

>look at paper
Oh this is Krsevan test... *looks closely* ... OMG his name is not Krsevan it is Luka

>look at banana
This banana has massage on it: "Sarmelo is crazy for bananas soo I will gift him one"

Player: ~~I feel dizzy... why is this green trying to attack me... damn green~~

>[enter]
You find yourself again in a nearly empty room. The walls are gray and bare. Its ticking echoes in your mind, strangely familiar yet distant.

* * *

>go west
The Town Square
You step outside into the bustling town square. The air is filled with the sound of distant chatter and the smell of fresh bread from the bakery. In front of you, there are four people standing: three of them are strangers, and only one of them feels oddly familiar - Krševan.

You can see Sarmelo, Nona and Laura here.

Player: Laura is back from shopping. I should probably ask her about the banana.

>ask laura about banana
Laura: OOO Yeaa! Take it (Type take hidden banana)

Player: ~~I feel dizzy... why is this green trying to attack me... damn green~~

>[enter]
You find yourself again in a nearly empty room. The walls are gray and bare. Its ticking echoes in your mind, strangely familiar yet distant.

* * *

>take hidden banana
Laura gave you banana! Now you can gift it to someone.

>[enter]
Laura: By the way, do you know what's with Luka? He looks angry... and because of that, he doesn't want to play Catan :(

>[enter]
Choose answer: 
 3) Oooo, he is moody but I will see what I can do
 4) No 
Taken.

Player: ~~I feel dizzy... why is this green trying to attack me... damn green~~

>3
You find yourself again in a nearly empty room. The walls are gray and bare. Its ticking echoes in your mind, strangely familiar yet distant.

>[enter]
You should probably go and see Laura

Player: Laura is back from shopping. I should probably ask her about the banana.

>4
Laura: No? Fair I wouldn't eather! See you later...
That's not a verb I recognise.

I beg your pardon?

>3
Laura: Oh ok good I don't have time for Luka right know, but I am ready to win in Catan
Player *thinks* ~Why is everyone now ready for Catan does it connect somehow with that one wierd dream....~

>[enter]
Player *thinks* ~I should appology to Krsevan... I mean Luka about his name~That's not a verb I recognise.

>give sarmelo banana
(first taking the hidden banana)

Sarmelo takes the banana and starts eating it with great satisfaction.

>[enter]
Sarmelo: "Ah, this is the best banana ever! Thank you, you've saved me."

Player: ~~I feel dizzy... why is this green trying to attack me... damn green~~

>[enter]
You find yourself again in a nearly empty room. The walls are gray and bare. Its ticking echoes in your mind, strangely familiar yet distant.

* * *

>[enter]
You should probably go and see Laura

Player: Laura is back from shopping. I should probably ask her about the banana.

>luka
Luka: Ohhh soo you are now done with that joke... ok...

* * *

>[enter]
Luka: Now that I am happy we can go and play Catan. I will show you how to win
 Player: Yea like you would win anyway

>[enter]
Player *thinks* Ok so now I just need to ask Sarmelo if he wants to play Catan.Now everyone is happy and waiting for me to play catan.

 Player moves to living room where everyone is playing catan but everything feels similar
 Player thinks ~is this deja vu!?~
Living Room
A cozy living room with a sofa and a small coffee table. The air smells faintly of lavender.

 After playing for 30 min player is going to win... but when all of a sudden the player slipps from SARMEL'S BANANA PEEL AND STARTS TO FALL

>[enter]
Player hits his head hard on the floor....

>[enter]
You feel dizzy trie to move (type "reset" to regain your senses).
That's not a verb I recognise.

I beg your pardon?

>reset
Now everyone is happy and waiting for me to play catan.

 Player moves to living room where everyone is playing catan but everything feels similar
 Player thinks ~is this deja vu!?~
Living Room
A cozy living room with a sofa and a small coffee table. The air smells faintly of lavender.

You can see Krsevan, Sarmelo, Nona and Laura here.

 After playing for 30 min player is going to win... but when all of a sudden the player slipps from SARMEL'S BANANA PEEL AND STARTS TO FALL

>[enter]
Player hits his head hard on the floor....

* * *

>[enter]
You feel dizzy trie to move (type "reset" to regain your senses).
That's not a verb I recognise.

>reset
Now everyone is happy and waiting for me to play catan.

 Player moves to living room where everyone is playing catan but everything feels similar
 Player thinks ~is this deja vu!?~
Living Room
A cozy living room with a sofa and a small coffee table. The air smells faintly of lavender.

You can see Krsevan, Sarmelo, Nona and Laura here.

 After playing for 30 min player is going to win... but when all of a sudden the player slipps from SARMEL'S BANANA PEEL AND STARTS TO FALL

* * *

>[enter]
You feel dizzy trie to move (type "reset" to regain your senses).
That's not a verb I recognise.

>restart
Now everyone is happy and waiting for me to play catan.

 Player moves to living room where everyone is playing catan but everything feels similar
 Player thinks ~is this deja vu!?~
Living Room
A cozy living room with a sofa and a small coffee table. The air smells faintly of lavender.

You can see Krsevan, Sarmelo, Nona and Laura here.

 After playing for 30 min player is going to win... but when all of a sudden the player slipps from SARMEL'S BANANA PEEL AND STARTS TO FALL

* * *

>[enter]
You feel dizzy trie to move (type "reset" to regain your senses).

Are you sure you want to restart?

>y
Welcome
An Interactive Fiction
Release 1 / Serial number 250109 / Inform 7 v10.1.2 / D

Soba of Awakening
You find yourself in a nearly empty room. The walls are gray and bare. In the middle of the room stands an old wooden table with a single chair. Hanging on the wall is an antique clock. Its ticking echoes in your mind, strangely familiar yet distant. A vague memory lingers in your mind - the sensation of falling this is something you will never forget, and the surname "Krševean" echoes faintly in the distance, though you can't quite remember its significance.

You can see a wooden table and an antique clock here.

* * *

>go west
The Town Square
You step outside into the bustling town square. The air is filled with the sound of distant chatter and the smell of fresh bread from the bakery. In front of you, there are four people standing: three of them are strangers, and only one of them feels oddly familiar - Krševan.

You can see Krsevan here.

>go east
Soba of Awakening
You find yourself in a nearly empty room. The walls are gray and bare. In the middle of the room stands an old wooden table with a single chair. Hanging on the wall is an antique clock, its ticking echoing in your mind-strangely familiar yet distant. A vague memory lingers: the sensation of falling. This is something you will never forget, and the surname "Krševean" echoes faintly in the distance, though you can't quite remember its significance.

You can see a wooden table and an antique clock here.

>go north
You can't go north yet. Something is blocking your way.

>go east
You can't go that way.

>go west
The Town Square
You step outside into the bustling town square. The air is filled with the sound of distant chatter and the smell of fresh bread from the bakery. In front of you, there are four people standing: three of them are strangers, and only one of them feels oddly familiar - Krševan.

You can see Krsevan here.

>look
The Town Square
You step outside into the bustling town square. The air is filled with the sound of distant chatter and the smell of fresh bread from the bakery. In front of you, there are four people standing: three of them are strangers, and only one of them feels oddly familiar - Krševan.

You can see Krsevan here.

>ask krsevan about town
Krsevan seems irritated. He doesn't want to talk right now. He looks like he's in no mood for conversation. He tells you to talk with Laura, Nona, and Sarmelo.

* * *

>ask laura about town
Laura seems lost in thought. She doesn't seem to want to talk right now. Perhaps she's too focused on her cravings.

>ask laura about town
Laura seems lost in thought. She doesn't seem to want to talk right now. Perhaps she's too focused on her cravings.

The sound of the clock grows louder and more insistent. You feel its ticking resonating in your mind, as if urging you to act. It is sooooo loud you need to go back to room (east) and turn it of
The sound of the clock becomes deafening. You feel an overwhelming urge to return to the Soba of Awakening. (east)

* * *

>look at paper
Oh this is Krsevan test... *looks closely* ... OMG his name is not Krsevan it is Luka

>look at banana
This banana has massage on it: "Sarmelo is crazy for bananas soo I will gift him one"

Player: ~~I feel dizzy... why is this green trying to attack me... damn green~~
You find yourself again in a nearly empty room. The walls are gray and bare. Its ticking echoes in your mind, strangely familiar yet distant.  
 you should probabaly go and see Laura

>power of thinking
Your insight is: 
Sarmelo probably is crayz for bananas?? and Krsevans name is Luka??? is he angry about that??That's not a verb I recognise.

>go west
The Town Square
You step outside into the bustling town square. The air is filled with the sound of distant chatter and the smell of fresh bread from the bakery. In front of you, there are four people standing: three of them are strangers, and only one of them feels oddly familiar - Krševan.

You can see Sarmelo, Nona and Laura here.

Player: Laura is back from shopping I should probably ask her about banana

>ask laura about banana
Laura: OOO Yeaa! Take it (Type take banana)

Player: ~~I feel dizzy... why is this green trying to attack me... damn green~~
You find yourself again in a nearly empty room. The walls are gray and bare. Its ticking echoes in your mind, strangely familiar yet distant.  
 you should probabaly go and see Laura

Player: Laura is back from shopping I should probably ask her about banana

>take banana
Laura gave you banana! Now you can gift it to someone.

Laura: By the way, do you know what's with Luka? He looks angry... and because of that, he doesn't want to play Catan :(
 Choose answer: 
 3) Oooo, he is moody but I will see what I can do
 4) No 
Taken.

Player: ~~I feel dizzy... why is this green trying to attack me... damn green~~
You find yourself again in a nearly empty room. The walls are gray and bare. Its ticking echoes in your mind, strangely familiar yet distant.  
 you should probabaly go and see Laura

Player: Laura is back from shopping I should probably ask her about banana

>3
Laura: Oh ok good I don't have time for Luka right know, but I am ready to win in Catan
Player *thinks* ~Why is everyone now ready for Catan does it connect somehow with that one wierd dream....~
Player *thinks* ~I should appology to Krsevan... I mean Luka about his name~That's not a verb I recognise.

>luka
Luka: Ohhh soo you are now done with that joke... ok...

Luka: Now that I am happy we can go and play Catan. I will show you how to win
 Player: Yea like you would win anyway
 Player *thinks* Ok so now I just need to ask Sarmelo if he wants to play Catan.
That's not a verb I recognise.

>ask sarmelo about catan
Sarmelo: No, I need something!!!

>inventory
You are carrying nothing.

>look
The Town Square
You step outside into the bustling town square. The air is filled with the sound of distant chatter and the smell of fresh bread from the bakery. In front of you, there are four people standing: three of them are strangers, and only one of them feels oddly familiar - Krševan.

You can see a hidden banana, Krsevan, Sarmelo, Nona and Laura here.

>take banana
Laura gave you banana! Now you can gift it to someone.

Laura: By the way, do you know what's with Luka? He looks angry... and because of that, he doesn't want to play Catan :(
 Choose answer: 
 3) Oooo, he is moody but I will see what I can do
 4) No 
Taken.

Player: ~~I feel dizzy... why is this green trying to attack me... damn green~~
You find yourself again in a nearly empty room. The walls are gray and bare. Its ticking echoes in your mind, strangely familiar yet distant.  
 you should probabaly go and see Laura

Player: Laura is back from shopping I should probably ask her about banana

>take hidden banana
Taken.

Player: ~~I feel dizzy... why is this green trying to attack me... damn green~~
You find yourself again in a nearly empty room. The walls are gray and bare. Its ticking echoes in your mind, strangely familiar yet distant.  
 you should probabaly go and see Laura

Player: Laura is back from shopping I should probably ask her about banana

>ask sarmelo about catan
Sarmelo: No, I need something!!!

* * *

>look at clokc
You can't see any such thing.

>look at clock
The clock ticks, steady and calm, as if it is just a normal antique.

>go west
The Town Square
You step outside into the bustling town square. The air is filled with the sound of distant chatter and the smell of fresh bread from the bakery. In front of you, there are four people standing: three of them are strangers, and only one of them feels oddly familiar - Krševan.

You can see Krsevan here.

* * *

>go west
The Town Square
You step outside into the bustling town square. The air is filled with the sound of distant chatter and the smell of fresh bread from the bakery. In front of you, there are four people standing: three of them are strangers, and only one of them feels oddly familiar - Krševan.

You can see Sarmelo, Nona, Laura and Krsevan here.

>your ticket is on email
Nona: WHAT DO YOU KNO... Wait they are on my email... Well *rolls her eyes* that is a relief

* * *

>[enter]
Player: WHATTTT??? 
 What is happening... Why is everything so noisy? 
(new place unlocked: living room) 
 Player: I should go and check what is happening in living room (north)
You aren't feeling especially drowsy.

I beg your pardon?

>go north
Player: Why is Laura, Nona, Sarmelo and Krsevan here and what are they doing???

* * *

>1
Laura: Oh, okay, good. I don't have time for you right now. I just have this weird craving and I don't know for what. Any idea??
That's not a verb I recognise.

I beg your pardon?

>pilk
Laura: OMG, yes, that's exactly what I need! Thank you so much. Now I can buy what I need. Do you want something, like fruit or something...?

* * *

>[enter]
You should probably go and see Laura

>look
Soba of Awakening
You find yourself again in a nearly empty room. The walls are gray and bare. Its ticking echoes in your mind, strangely familiar yet distant.

You can see a hidden banana, a hidden paper, Krsevan, a wooden table and an antique clock here.

* * *

>power of thinking
Your insight is: That's not a verb I recognise.

>go west
The Town Square
You step outside into the bustling town square. The air is filled with the sound of distant chatter and the smell of fresh bread from the bakery. In front of you, there are four people standing: three of them are strangers, and only one of them feels oddly familiar - Krševan.

You can see Krsevan here.

* * *

>power of thinking
Your insight is: Nona's flight tickets are on emailThat's not a verb I recognise.

* * *

>restart
Are you sure you want to restart?

>y
Welcome
An Interactive Fiction
Release 1 / Serial number 250109 / Inform 7 v10.1.2 / D

Soba of Awakening
You find yourself in a nearly empty room. The walls are gray and bare. In the middle of the room stands an old wooden table with a single chair. Hanging on the wall is an antique clock. Its ticking echoes in your mind, strangely familiar yet distant. A vague memory lingers in your mind - the sensation of falling, and the surname "Krševean" echoes faintly in the distance, though you can't quite remember its significance.

You can see a wooden table and an antique clock here.

* * *

>take apple
Taken.

>eat apple
You eat the apple. Not bad.

* * *

>w
The Town Square
You step outside into the bustling town square. The air is filled with the sound of distant chatter and the smell of fresh bread from the bakery. In front of you, there are four people standing: three of them are strangers, and only one of them feels oddly familiar - Krševan.

You can see Krsevan here.

>ask krsevan about t
Krsevan seems irritated. He doesn't want to talk right now. He looks like he's in no mood for conversation. He tells you to talk with Laura, Nona, and Sarmelo.

>ask nona about t
Nona doesn't seem interested in talking right now, she's too focused on finding her lost tickets.

>ask nona about t
Nona doesn't seem interested in talking right now, she's too focused on finding her lost tickets.

The sound of the clock grows louder and more insistent. You feel its ticking resonating in your mind, as if urging you to act. It is so loud that you need to go back to the room (east) and turn it off
The sound of the clock becomes deafening. You feel an overwhelming urge to return to the Soba of Awakening. (east)

>e
The dizziness overwhelms you, and you need a moment to steady yourself.

Soba of Awakening
You stagger back into the room, your head spinning. You feel dizzy, and the air seems to buzz around you. The room has changed. It looks much tidier and cleaner now, as though someone has spent a long time organizing it. The once-bare walls are now spotless, and the table is neatly arranged with a small, mysterious object on it. The clock ticks more softly, almost as if it's calming you. You wonder if everything that just happened was real.

You can see Nona computer, a wooden table and an antique clock here.

* * *

>[enter]
Player **thinks**~~I should go to room and sleep to clear my mind. What happened today? Why was the clock so loud, and where was I in that purple room? Did I go crazy?~~That's not a verb I recognise.

>w
You can't go that way.

>e
Soba of Awakening

 You find yourself again in a nearly empty room. The walls are gray and bare. Its ticking echoes in your mind, strangely familiar yet distant.

You can see a wooden table and an antique clock here.

* * *

>n
Player: Why is Laura, Nona, Sarmelo and Krsevan here and what are they doing???

>[enter]
It looks like they are playing some game... is that... catan and Krsevan is winning... no wayyy...

>[enter]
Player: I want to join and show you how to play catan.

* * *

>1
Laura: Oh, okay, good. I don't have time for you right now. I just have this weird craving and I don't know for what. Any idea?? (you should just say drink you know she loves).
That's not a verb I recognise.

>pilk
Laura: OMG, yes, that's exactly what I need! Thank you so much. Now I can buy what I need. Do you want something, like fruit or something...?

* * *

>[enter]
The sound of the clock grows louder and more insistent. You feel its ticking resonating in your mind, as if urging you to act. You need to run and see that clockThat's not a verb I recognise.

>e
Soba of Awakening

 You find yourself again in a nearly empty room. The walls are gray and bare. Its ticking echoes in your mind, strangely familiar yet distant.

You can see a wooden table and an antique clock here.

Player: What is happening with this clock? I NEED TO SMASH IT, I CANNOT WITH THIS SOUND!

Weird noises: smash.... smash.... smash........

* * *

>w
The Town Square
You step outside into the bustling town square. The air is filled with the sound of distant chatter and the smell of fresh bread from the bakery. In front of you, there are four people standing: three of them are strangers, and only one of them feels oddly familiar - Krševan.

You can see Sarmelo, Nona and Laura here.

>ask laura about banana
Laura: OOO Yeaa! Take it (Type take hidden banana)

Player: ~~I feel dizzy... why is this green so overwhelming... damn, the green~~

* * *

>w
The Town Square
You step outside into the bustling town square. The air is filled with the sound of distant chatter and the smell of fresh bread from the bakery. In front of you, there are four people standing: three of them are strangers, and only one of them feels oddly familiar - Krševan.

You can see Krsevan here.

>ask krsevan about town
Krsevan seems irritated. He doesn't want to talk right now. He looks like he's in no mood for conversation. He tells you to talk with Laura, Nona, and Sarmelo.

* * *

>[enter]
What is happening room was purple with tiger print all around me.... and the clock was so lound but now it's quiet
I should ask Nona about this mybe she knows something about flight

>go e
You can't go that way.

>go w
The Town Square
You step outside into the bustling town square. The air is filled with the sound of distant chatter and the smell of fresh bread from the bakery. In front of you, there are four people standing: three of them are strangers, and only one of them feels oddly familiar - Krševan.

You can see Sarmelo, Nona, Laura and Krsevan here.

>your ticket is on email
Nona: WHAT DO YOU KNO... Wait they are on my email... Well *rolls her eyes* that is a relief.

* * *

>[enter]
Player **thinks**~~I should go to room and sleep to clear my mind. What happened today? Why was the clock so loud, and where was I in that purple room? Did I go crazy?~~That's not a verb I recognise.

>go w
You can't go that way.

>sleep
You aren't feeling especially drowsy.

>go n
You can't go that way.

>n
You can't go that way.

>go e
Soba of Awakening

 You find yourself again in a nearly empty room. The walls are gray and bare. Its ticking echoes in your mind, strangely familiar yet distant.

You can see a wooden table and an antique clock here.

>sleep
Player fell asleep
 The sound of the clock grows louder and more insistent. You feel its ticking resonating in your mind, as if urging you to act. It wakes you up.

* * *

>[enter]
Player: WHATTTT??? 
 What is happening... Why is everything so noisy? 
(new place unlocked: living room) 
 Player: I should go and check what is happening in living room (north).

You aren't feeling especially drowsy.

>n
Player: Why is Laura, Nona, Sarmelo and Krsevan here and what are they doing???

* * *

I beg your pardon?

>1
Laura: Oh, okay, good. I don't have time for you right now. I just have this weird craving and I don't know for what. Any idea?? (you should just say drink you know she loves).
That's not a verb I recognise.

* * *

>[enter]
*Thinks*~~Huh, what's up with him??? Anyway, let's explore the room. Maybe I will understand what is happening. (look)~~

>look at banana
This banana has massage on it: "Sarmelo is crazy for bananas soo I will gift him one"

Player: ~~I feel dizzy... why is this green so overwhelming... damn, the green~~

* * *

>[enter]
You should probably go and see Laura

Player: Laura is back from shopping. I should probably ask her about the banana.

>w
The Town Square
You step outside into the bustling town square. The air is filled with the sound of distant chatter and the smell of fresh bread from the bakery. In front of you, there are four people standing: three of them are strangers, and only one of them feels oddly familiar - Krševan.

You can see a hidden banana, Krsevan, Sarmelo, Nona and Laura here.

>ask laura about banana
Laura: OOO Yeaa! Take it (Type take hidden banana)

Player: ~~I feel dizzy... why is this green so overwhelming... damn, the green~~

* * *

>[enter]
You should probably go and see Laura

Player: Laura is back from shopping. I should probably ask her about the banana.

>take banana
Laura gave you banana! Now you can gift it to someone.

>[enter]
Laura: By the way, do you know what's up with Luka? He looks angry... and because of that, he doesn't want to play Catan. :(

* * *

>[enter]
Choose answer: 
 3) Oooo, he is moody but I will see what I can do
 4) No 
Taken.

Player: ~~I feel dizzy... why is this green so overwhelming... damn, the green~~

>3
You find yourself again in a nearly empty room. The walls are gray and bare. Its ticking echoes in your mind, strangely familiar yet distant.

>4
You should probably go and see Laura

Player: Laura is back from shopping. I should probably ask her about the banana.

>3
Laura: Oh, okay, good. I don't have time for Luka right now, but I'm ready to win at Catan!

Player *thinks* ~Why is everyone ready for Catan now? Does it somehow connect with that one weird dream..~

* * *

>[enter]
Player *thinks* ~I should apologize to Krsevan... I mean Luka, about his name.~ (call krsevan by his name)That's not a verb I recognise.

I beg your pardon?